"AGNO_TOTAL","RBD","RURAL_RBD_MUESTRA","NOM_COM_RBD_MUESTRA","NOMBRE_SLEP_MUESTRA","ESTADO_ESTAB_MUESTRA","SLEP_MUESTRA","MAT_HOM_TOT","MAT_MUJ_TOT","MAT_TOTAL"
"2017",1,"0","ARICA               ","CHINCHORRO","1","5",451,351,802
"2018",1,"0","ARICA               ","CHINCHORRO","1","5",379,295,674
"2019",1,"0","ARICA               ","CHINCHORRO","1","5",375,291,666
"2020",1,"0","ARICA               ","CHINCHORRO","1","5",338,265,603
"2021",1,"0","ARICA               ","CHINCHORRO","1","5",401,263,664
"2022",1,"0","ARICA               ","CHINCHORRO","1","5",400,267,667
"2023",1,"0","ARICA               ","CHINCHORRO","1","5",473,314,787
"2024",1,"0","ARICA               ","CHINCHORRO","1","5",516,324,840
"2017",2,"0","ARICA               ","CHINCHORRO","1","5",108,92,200
"2018",2,"0","ARICA               ","CHINCHORRO","1","5",99,86,185
"2019",2,"0","ARICA               ","CHINCHORRO","1","5",106,105,211
"2020",2,"0","ARICA               ","CHINCHORRO","1","5",103,97,200
"2021",2,"0","ARICA               ","CHINCHORRO","1","5",81,89,170
"2022",2,"0","ARICA               ","CHINCHORRO","1","5",84,82,166
"2023",2,"0","ARICA               ","CHINCHORRO","1","5",70,63,133
"2024",2,"0","ARICA               ","CHINCHORRO","1","5",60,61,121
"2017",3,"1","ARICA               ","CHINCHORRO","1","5",373,131,504
"2018",3,"1","ARICA               ","CHINCHORRO","1","5",396,115,511
"2019",3,"1","ARICA               ","CHINCHORRO","1","5",334,78,412
"2020",3,"1","ARICA               ","CHINCHORRO","1","5",373,96,469
"2021",3,"1","ARICA               ","CHINCHORRO","1","5",469,1,470
"2022",3,"1","ARICA               ","CHINCHORRO","1","5",376,0,376
"2023",3,"1","ARICA               ","CHINCHORRO","1","5",461,0,461
"2024",3,"1","ARICA               ","CHINCHORRO","1","5",587,1,588
"2017",4,"0","ARICA               ","CHINCHORRO","1","5",506,581,1087
"2018",4,"0","ARICA               ","CHINCHORRO","1","5",471,540,1011
"2019",4,"0","ARICA               ","CHINCHORRO","1","5",450,527,977
"2020",4,"0","ARICA               ","CHINCHORRO","1","5",450,540,990
"2021",4,"0","ARICA               ","CHINCHORRO","1","5",443,531,974
"2022",4,"0","ARICA               ","CHINCHORRO","1","5",460,554,1014
"2023",4,"0","ARICA               ","CHINCHORRO","1","5",535,616,1151
"2024",4,"0","ARICA               ","CHINCHORRO","1","5",609,594,1203
"2017",5,"0","ARICA               ","CHINCHORRO","1","5",526,449,975
"2018",5,"0","ARICA               ","CHINCHORRO","1","5",519,471,990
"2019",5,"0","ARICA               ","CHINCHORRO","1","5",523,469,992
"2020",5,"0","ARICA               ","CHINCHORRO","1","5",479,413,892
"2021",5,"0","ARICA               ","CHINCHORRO","1","5",437,381,818
"2022",5,"0","ARICA               ","CHINCHORRO","1","5",416,355,771
"2023",5,"0","ARICA               ","CHINCHORRO","1","5",441,375,816
"2024",5,"0","ARICA               ","CHINCHORRO","1","5",428,369,797
"2017",7,"0","ARICA               ","CHINCHORRO","1","5",637,429,1066
"2018",7,"0","ARICA               ","CHINCHORRO","1","5",681,463,1144
"2019",7,"0","ARICA               ","CHINCHORRO","1","5",673,446,1119
"2020",7,"0","ARICA               ","CHINCHORRO","1","5",676,449,1125
"2021",7,"0","ARICA               ","CHINCHORRO","1","5",689,455,1144
"2022",7,"0","ARICA               ","CHINCHORRO","1","5",690,473,1163
"2023",7,"0","ARICA               ","CHINCHORRO","1","5",656,496,1152
"2024",7,"0","ARICA               ","CHINCHORRO","1","5",600,498,1098
"2017",8,"0","ARICA               ","CHINCHORRO","1","5",364,285,649
"2018",8,"0","ARICA               ","CHINCHORRO","1","5",358,292,650
"2019",8,"0","ARICA               ","CHINCHORRO","1","5",357,292,649
"2020",8,"0","ARICA               ","CHINCHORRO","1","5",344,280,624
"2021",8,"0","ARICA               ","CHINCHORRO","1","5",410,260,670
"2022",8,"0","ARICA               ","CHINCHORRO","1","5",417,284,701
"2023",8,"0","ARICA               ","CHINCHORRO","1","5",347,273,620
"2024",8,"0","ARICA               ","CHINCHORRO","1","5",389,302,691
"2017",9,"0","ARICA               ","CHINCHORRO","1","5",793,736,1529
"2018",9,"0","ARICA               ","CHINCHORRO","1","5",807,727,1534
"2019",9,"0","ARICA               ","CHINCHORRO","1","5",782,708,1490
"2020",9,"0","ARICA               ","CHINCHORRO","1","5",769,702,1471
"2021",9,"0","ARICA               ","CHINCHORRO","1","5",736,700,1436
"2022",9,"0","ARICA               ","CHINCHORRO","1","5",744,681,1425
"2023",9,"0","ARICA               ","CHINCHORRO","1","5",745,680,1425
"2024",9,"0","ARICA               ","CHINCHORRO","1","5",734,692,1426
"2017",10,"0","ARICA               ","CHINCHORRO","1","5",1,157,158
"2018",10,"0","ARICA               ","CHINCHORRO","1","5",2,160,162
"2019",10,"0","ARICA               ","CHINCHORRO","1","5",0,181,181
"2020",10,"0","ARICA               ","CHINCHORRO","1","5",0,192,192
"2021",10,"0","ARICA               ","CHINCHORRO","1","5",6,197,203
"2022",10,"0","ARICA               ","CHINCHORRO","1","5",0,224,224
"2023",10,"0","ARICA               ","CHINCHORRO","1","5",5,164,169
"2024",10,"0","ARICA               ","CHINCHORRO","1","5",0,158,158
"2017",11,"0","ARICA               ","CHINCHORRO","1","5",228,169,397
"2018",11,"0","ARICA               ","CHINCHORRO","1","5",222,147,369
"2019",11,"0","ARICA               ","CHINCHORRO","1","5",205,160,365
"2020",11,"0","ARICA               ","CHINCHORRO","1","5",199,149,348
"2021",11,"0","ARICA               ","CHINCHORRO","1","5",183,149,332
"2022",11,"0","ARICA               ","CHINCHORRO","1","5",176,141,317
"2023",11,"0","ARICA               ","CHINCHORRO","1","5",196,137,333
"2024",11,"0","ARICA               ","CHINCHORRO","1","5",199,150,349
"2017",12,"0","ARICA               ","CHINCHORRO","1","5",173,148,321
"2018",12,"0","ARICA               ","CHINCHORRO","1","5",180,143,323
"2019",12,"0","ARICA               ","CHINCHORRO","1","5",167,147,314
"2020",12,"0","ARICA               ","CHINCHORRO","1","5",177,150,327
"2021",12,"0","ARICA               ","CHINCHORRO","1","5",179,149,328
"2022",12,"0","ARICA               ","CHINCHORRO","1","5",188,149,337
"2023",12,"0","ARICA               ","CHINCHORRO","1","5",175,147,322
"2024",12,"0","ARICA               ","CHINCHORRO","1","5",179,147,326
"2017",13,"0","ARICA               ","CHINCHORRO","1","5",158,108,266
"2018",13,"0","ARICA               ","CHINCHORRO","1","5",158,105,263
"2019",13,"0","ARICA               ","CHINCHORRO","1","5",160,114,274
"2020",13,"0","ARICA               ","CHINCHORRO","1","5",159,121,280
"2021",13,"0","ARICA               ","CHINCHORRO","1","5",165,108,273
"2022",13,"0","ARICA               ","CHINCHORRO","1","5",149,125,274
"2023",13,"0","ARICA               ","CHINCHORRO","1","5",171,107,278
"2024",13,"0","ARICA               ","CHINCHORRO","1","5",149,113,262
"2017",14,"0","ARICA               ","CHINCHORRO","1","5",128,89,217
"2018",14,"0","ARICA               ","CHINCHORRO","1","5",162,129,291
"2019",14,"0","ARICA               ","CHINCHORRO","1","5",178,151,329
"2020",14,"0","ARICA               ","CHINCHORRO","1","5",215,134,349
"2021",14,"0","ARICA               ","CHINCHORRO","1","5",210,136,346
"2022",14,"0","ARICA               ","CHINCHORRO","1","5",201,150,351
"2023",14,"0","ARICA               ","CHINCHORRO","1","5",205,164,369
"2024",14,"0","ARICA               ","CHINCHORRO","1","5",202,160,362
"2017",15,"0","ARICA               ","CHINCHORRO","1","5",184,198,382
"2018",15,"0","ARICA               ","CHINCHORRO","1","5",194,215,409
"2019",15,"0","ARICA               ","CHINCHORRO","1","5",185,214,399
"2020",15,"0","ARICA               ","CHINCHORRO","1","5",177,217,394
"2021",15,"0","ARICA               ","CHINCHORRO","1","5",168,228,396
"2022",15,"0","ARICA               ","CHINCHORRO","1","5",167,214,381
"2023",15,"0","ARICA               ","CHINCHORRO","1","5",161,231,392
"2024",15,"0","ARICA               ","CHINCHORRO","1","5",163,235,398
"2017",16,"0","ARICA               ","CHINCHORRO","1","5",184,91,275
"2018",16,"0","ARICA               ","CHINCHORRO","1","5",168,77,245
"2019",16,"0","ARICA               ","CHINCHORRO","1","5",193,98,291
"2020",16,"0","ARICA               ","CHINCHORRO","1","5",200,111,311
"2021",16,"0","ARICA               ","CHINCHORRO","1","5",196,112,308
"2022",16,"0","ARICA               ","CHINCHORRO","1","5",198,105,303
"2023",16,"0","ARICA               ","CHINCHORRO","1","5",185,110,295
"2024",16,"0","ARICA               ","CHINCHORRO","1","5",193,103,296
"2017",17,"0","ARICA               ","CHINCHORRO","1","5",162,173,335
"2018",17,"0","ARICA               ","CHINCHORRO","1","5",176,176,352
"2019",17,"0","ARICA               ","CHINCHORRO","1","5",195,191,386
"2020",17,"0","ARICA               ","CHINCHORRO","1","5",209,204,413
"2021",17,"0","ARICA               ","CHINCHORRO","1","5",228,198,426
"2022",17,"0","ARICA               ","CHINCHORRO","1","5",245,205,450
"2023",17,"0","ARICA               ","CHINCHORRO","1","5",235,188,423
"2024",17,"0","ARICA               ","CHINCHORRO","1","5",236,190,426
"2017",18,"0","ARICA               ","CHINCHORRO","1","5",186,144,330
"2018",18,"0","ARICA               ","CHINCHORRO","1","5",181,136,317
"2019",18,"0","ARICA               ","CHINCHORRO","1","5",201,145,346
"2020",18,"0","ARICA               ","CHINCHORRO","1","5",194,135,329
"2021",18,"0","ARICA               ","CHINCHORRO","1","5",191,141,332
"2022",18,"0","ARICA               ","CHINCHORRO","1","5",190,151,341
"2023",18,"0","ARICA               ","CHINCHORRO","1","5",181,135,316
"2024",18,"0","ARICA               ","CHINCHORRO","1","5",179,146,325
"2017",19,"0","ARICA               ","CHINCHORRO","1","5",185,151,336
"2018",19,"0","ARICA               ","CHINCHORRO","1","5",186,140,326
"2019",19,"0","ARICA               ","CHINCHORRO","1","5",168,136,304
"2020",19,"0","ARICA               ","CHINCHORRO","1","5",169,135,304
"2021",19,"0","ARICA               ","CHINCHORRO","1","5",159,133,292
"2022",19,"0","ARICA               ","CHINCHORRO","1","5",164,146,310
"2023",19,"0","ARICA               ","CHINCHORRO","1","5",159,146,305
"2024",19,"0","ARICA               ","CHINCHORRO","1","5",157,142,299
"2017",20,"0","ARICA               ","CHINCHORRO","1","5",256,196,452
"2018",20,"0","ARICA               ","CHINCHORRO","1","5",268,203,471
"2019",20,"0","ARICA               ","CHINCHORRO","1","5",254,207,461
"2020",20,"0","ARICA               ","CHINCHORRO","1","5",252,190,442
"2021",20,"0","ARICA               ","CHINCHORRO","1","5",266,197,463
"2022",20,"0","ARICA               ","CHINCHORRO","1","5",267,210,477
"2023",20,"0","ARICA               ","CHINCHORRO","1","5",293,184,477
"2024",20,"0","ARICA               ","CHINCHORRO","1","5",265,182,447
"2017",22,"0","ARICA               ","CHINCHORRO","1","5",540,460,1000
"2018",22,"0","ARICA               ","CHINCHORRO","1","5",548,484,1032
"2019",22,"0","ARICA               ","CHINCHORRO","1","5",517,434,951
"2020",22,"0","ARICA               ","CHINCHORRO","1","5",524,438,962
"2021",22,"0","ARICA               ","CHINCHORRO","1","5",509,432,941
"2022",22,"0","ARICA               ","CHINCHORRO","1","5",510,448,958
"2023",22,"0","ARICA               ","CHINCHORRO","1","5",485,451,936
"2024",22,"0","ARICA               ","CHINCHORRO","1","5",424,415,839
"2017",25,"0","ARICA               ","CHINCHORRO","1","5",353,271,624
"2018",25,"0","ARICA               ","CHINCHORRO","1","5",383,284,667
"2019",25,"0","ARICA               ","CHINCHORRO","1","5",382,305,687
"2020",25,"0","ARICA               ","CHINCHORRO","1","5",385,316,701
"2021",25,"0","ARICA               ","CHINCHORRO","1","5",419,337,756
"2022",25,"0","ARICA               ","CHINCHORRO","1","5",461,386,847
"2023",25,"0","ARICA               ","CHINCHORRO","1","5",466,370,836
"2024",25,"0","ARICA               ","CHINCHORRO","1","5",451,376,827
"2017",26,"0","ARICA               ","CHINCHORRO","1","5",85,75,160
"2018",26,"0","ARICA               ","CHINCHORRO","1","5",91,89,180
"2019",26,"0","ARICA               ","CHINCHORRO","1","5",136,113,249
"2020",26,"0","ARICA               ","CHINCHORRO","1","5",131,119,250
"2021",26,"0","ARICA               ","CHINCHORRO","1","5",142,111,253
"2022",26,"0","ARICA               ","CHINCHORRO","1","5",133,108,241
"2023",26,"0","ARICA               ","CHINCHORRO","1","5",146,118,264
"2024",26,"0","ARICA               ","CHINCHORRO","1","5",138,123,261
"2017",27,"0","ARICA               ","CHINCHORRO","1","5",146,98,244
"2018",27,"0","ARICA               ","CHINCHORRO","1","5",162,110,272
"2019",27,"0","ARICA               ","CHINCHORRO","1","5",175,118,293
"2020",27,"0","ARICA               ","CHINCHORRO","1","5",194,114,308
"2021",27,"0","ARICA               ","CHINCHORRO","1","5",181,118,299
"2022",27,"0","ARICA               ","CHINCHORRO","1","5",190,129,319
"2023",27,"0","ARICA               ","CHINCHORRO","1","5",173,126,299
"2024",27,"0","ARICA               ","CHINCHORRO","1","5",173,131,304
"2017",28,"0","ARICA               ","CHINCHORRO","1","5",391,398,790
"2018",28,"0","ARICA               ","CHINCHORRO","1","5",378,375,753
"2019",28,"0","ARICA               ","CHINCHORRO","1","5",434,404,838
"2020",28,"0","ARICA               ","CHINCHORRO","1","5",421,380,801
"2021",28,"0","ARICA               ","CHINCHORRO","1","5",462,396,858
"2022",28,"0","ARICA               ","CHINCHORRO","1","5",446,378,824
"2023",28,"0","ARICA               ","CHINCHORRO","1","5",411,338,749
"2024",28,"0","ARICA               ","CHINCHORRO","1","5",405,352,757
"2017",29,"0","ARICA               ","CHINCHORRO","1","5",294,234,528
"2018",29,"0","ARICA               ","CHINCHORRO","1","5",288,235,523
"2019",29,"0","ARICA               ","CHINCHORRO","1","5",278,230,508
"2020",29,"0","ARICA               ","CHINCHORRO","1","5",269,225,494
"2021",29,"0","ARICA               ","CHINCHORRO","1","5",280,239,519
"2022",29,"0","ARICA               ","CHINCHORRO","1","5",317,274,591
"2023",29,"0","ARICA               ","CHINCHORRO","1","5",323,295,618
"2024",29,"0","ARICA               ","CHINCHORRO","1","5",311,290,601
"2017",30,"0","ARICA               ","CHINCHORRO","1","5",111,69,180
"2018",30,"0","ARICA               ","CHINCHORRO","1","5",107,62,169
"2019",30,"0","ARICA               ","CHINCHORRO","1","5",102,72,174
"2020",30,"0","ARICA               ","CHINCHORRO","1","5",93,63,156
"2021",30,"0","ARICA               ","CHINCHORRO","1","5",100,63,163
"2022",30,"0","ARICA               ","CHINCHORRO","1","5",124,73,197
"2023",30,"0","ARICA               ","CHINCHORRO","1","5",117,50,167
"2024",30,"0","ARICA               ","CHINCHORRO","1","5",109,49,158
"2017",31,"1","ARICA               ","CHINCHORRO","1","5",212,213,425
"2018",31,"1","ARICA               ","CHINCHORRO","1","5",214,205,419
"2019",31,"1","ARICA               ","CHINCHORRO","1","5",207,206,413
"2020",31,"1","ARICA               ","CHINCHORRO","1","5",209,206,415
"2021",31,"1","ARICA               ","CHINCHORRO","1","5",201,211,412
"2022",31,"1","ARICA               ","CHINCHORRO","1","5",212,202,414
"2023",31,"1","ARICA               ","CHINCHORRO","1","5",204,193,397
"2024",31,"1","ARICA               ","CHINCHORRO","1","5",205,188,393
"2017",32,"1","ARICA               ","CHINCHORRO","1","5",411,362,773
"2018",32,"1","ARICA               ","CHINCHORRO","1","5",382,334,716
"2019",32,"1","ARICA               ","CHINCHORRO","1","5",396,342,738
"2020",32,"1","ARICA               ","CHINCHORRO","1","5",411,345,756
"2021",32,"1","ARICA               ","CHINCHORRO","1","5",417,364,781
"2022",32,"1","ARICA               ","CHINCHORRO","1","5",439,360,799
"2023",32,"1","ARICA               ","CHINCHORRO","1","5",428,366,794
"2024",32,"1","ARICA               ","CHINCHORRO","1","5",439,380,819
"2017",33,"1","ARICA               ","CHINCHORRO","1","5",104,92,196
"2018",33,"1","ARICA               ","CHINCHORRO","1","5",110,98,208
"2019",33,"1","ARICA               ","CHINCHORRO","1","5",103,100,203
"2020",33,"1","ARICA               ","CHINCHORRO","1","5",101,96,197
"2021",33,"1","ARICA               ","CHINCHORRO","1","5",102,92,194
"2022",33,"1","ARICA               ","CHINCHORRO","1","5",107,94,201
"2023",33,"1","ARICA               ","CHINCHORRO","1","5",101,91,192
"2024",33,"1","ARICA               ","CHINCHORRO","1","5",106,92,198
"2017",35,"1","ARICA               ","CHINCHORRO","1","5",53,58,111
"2018",35,"1","ARICA               ","CHINCHORRO","1","5",57,63,120
"2019",35,"1","ARICA               ","CHINCHORRO","1","5",62,50,112
"2020",35,"1","ARICA               ","CHINCHORRO","1","5",56,54,110
"2021",35,"1","ARICA               ","CHINCHORRO","1","5",56,54,110
"2022",35,"1","ARICA               ","CHINCHORRO","1","5",57,56,113
"2023",35,"1","ARICA               ","CHINCHORRO","1","5",66,72,138
"2024",35,"1","ARICA               ","CHINCHORRO","1","5",62,74,136
"2017",36,"0","ARICA               ","CHINCHORRO","1","5",141,154,295
"2018",36,"0","ARICA               ","CHINCHORRO","1","5",124,147,271
"2019",36,"0","ARICA               ","CHINCHORRO","1","5",155,152,307
"2020",36,"0","ARICA               ","CHINCHORRO","1","5",150,139,289
"2021",36,"0","ARICA               ","CHINCHORRO","1","5",147,139,286
"2022",36,"0","ARICA               ","CHINCHORRO","1","5",168,151,319
"2023",36,"0","ARICA               ","CHINCHORRO","1","5",184,147,331
"2024",36,"0","ARICA               ","CHINCHORRO","1","5",175,156,331
"2017",38,"1","ARICA               ","CHINCHORRO","1","5",273,267,540
"2018",38,"1","ARICA               ","CHINCHORRO","1","5",271,264,535
"2019",38,"1","ARICA               ","CHINCHORRO","1","5",286,237,523
"2020",38,"1","ARICA               ","CHINCHORRO","1","5",269,235,504
"2021",38,"1","ARICA               ","CHINCHORRO","1","5",274,239,513
"2022",38,"1","ARICA               ","CHINCHORRO","1","5",273,236,509
"2023",38,"1","ARICA               ","CHINCHORRO","1","5",279,235,514
"2024",38,"1","ARICA               ","CHINCHORRO","1","5",270,228,498
"2017",39,"1","ARICA               ","CHINCHORRO","1","5",48,33,81
"2018",39,"1","ARICA               ","CHINCHORRO","1","5",44,35,79
"2019",39,"1","ARICA               ","CHINCHORRO","1","5",41,35,76
"2020",39,"1","ARICA               ","CHINCHORRO","1","5",36,34,70
"2021",39,"1","ARICA               ","CHINCHORRO","1","5",43,32,75
"2022",39,"1","ARICA               ","CHINCHORRO","1","5",40,30,70
"2023",39,"1","ARICA               ","CHINCHORRO","1","5",37,38,75
"2024",39,"1","ARICA               ","CHINCHORRO","1","5",42,37,79
"2017",41,"1","ARICA               ","CHINCHORRO","1","5",12,16,28
"2018",41,"1","ARICA               ","CHINCHORRO","1","5",12,14,26
"2019",41,"1","ARICA               ","CHINCHORRO","1","5",14,23,37
"2020",41,"1","ARICA               ","CHINCHORRO","1","5",16,27,43
"2021",41,"1","ARICA               ","CHINCHORRO","1","5",16,25,41
"2022",41,"1","ARICA               ","CHINCHORRO","1","5",21,26,47
"2023",41,"1","ARICA               ","CHINCHORRO","1","5",37,30,67
"2024",41,"1","ARICA               ","CHINCHORRO","1","5",42,35,77
"2017",42,"1","ARICA               ","CHINCHORRO","1","5",8,9,17
"2018",42,"1","ARICA               ","CHINCHORRO","1","5",11,13,24
"2019",42,"1","ARICA               ","CHINCHORRO","1","5",8,10,18
"2020",42,"1","ARICA               ","CHINCHORRO","1","5",8,10,18
"2021",42,"1","ARICA               ","CHINCHORRO","1","5",11,12,23
"2022",42,"1","ARICA               ","CHINCHORRO","1","5",11,11,22
"2023",42,"1","ARICA               ","CHINCHORRO","1","5",12,14,26
"2024",42,"1","ARICA               ","CHINCHORRO","1","5",13,12,25
"2017",70,"1","CAMARONES           ","CHINCHORRO","1","5",4,4,8
"2018",70,"1","CAMARONES           ","CHINCHORRO","1","5",4,5,9
"2019",70,"1","CAMARONES           ","CHINCHORRO","1","5",3,4,7
"2020",70,"1","CAMARONES           ","CHINCHORRO","1","5",6,2,8
"2021",70,"1","CAMARONES           ","CHINCHORRO","1","5",6,3,9
"2022",70,"1","CAMARONES           ","CHINCHORRO","1","5",10,1,11
"2023",70,"1","CAMARONES           ","CHINCHORRO","1","5",4,2,6
"2024",70,"1","CAMARONES           ","CHINCHORRO","1","5",7,3,10
"2017",72,"1","CAMARONES           ","CHINCHORRO","1","5",22,17,39
"2018",72,"1","CAMARONES           ","CHINCHORRO","1","5",33,23,56
"2019",72,"1","CAMARONES           ","CHINCHORRO","1","5",48,18,66
"2020",72,"1","CAMARONES           ","CHINCHORRO","1","5",36,31,67
"2021",72,"1","CAMARONES           ","CHINCHORRO","1","5",40,30,70
"2022",72,"1","CAMARONES           ","CHINCHORRO","1","5",32,36,68
"2023",72,"1","CAMARONES           ","CHINCHORRO","1","5",28,39,67
"2024",72,"1","CAMARONES           ","CHINCHORRO","1","5",33,43,76
"2017",74,"1","CAMARONES           ","CHINCHORRO","1","5",4,2,6
"2018",74,"1","CAMARONES           ","CHINCHORRO","1","5",7,5,12
"2019",74,"1","CAMARONES           ","CHINCHORRO","1","5",5,6,11
"2020",74,"1","CAMARONES           ","CHINCHORRO","1","5",8,6,14
"2021",74,"1","CAMARONES           ","CHINCHORRO","1","5",8,7,15
"2022",74,"1","CAMARONES           ","CHINCHORRO","1","5",8,7,15
"2023",74,"1","CAMARONES           ","CHINCHORRO","1","5",7,9,16
"2024",74,"1","CAMARONES           ","CHINCHORRO","1","5",6,6,12
"2017",75,"1","CAMARONES           ","CHINCHORRO","1","5",5,3,8
"2018",75,"1","CAMARONES           ","CHINCHORRO","1","5",2,0,2
"2019",75,"1","CAMARONES           ","CHINCHORRO","1","5",2,0,2
"2020",75,"1","CAMARONES           ","CHINCHORRO","1","5",4,0,4
"2021",75,"1","CAMARONES           ","CHINCHORRO","1","5",3,0,3
"2022",75,"1","CAMARONES           ","CHINCHORRO","1","5",3,1,4
"2023",75,"1","CAMARONES           ","CHINCHORRO","1","5",4,1,5
"2024",75,"1","CAMARONES           ","CHINCHORRO","1","5",1,1,2
"2017",76,"1","CAMARONES           ","CHINCHORRO","1","5",4,6,10
"2018",76,"1","CAMARONES           ","CHINCHORRO","1","5",4,5,9
"2019",76,"1","CAMARONES           ","CHINCHORRO","1","5",4,4,8
"2020",76,"1","CAMARONES           ","CHINCHORRO","1","5",4,1,5
"2021",76,"1","CAMARONES           ","CHINCHORRO","1","5",5,2,7
"2022",76,"1","CAMARONES           ","CHINCHORRO","1","5",6,2,8
"2023",76,"1","CAMARONES           ","CHINCHORRO","1","5",0,2,2
"2024",76,"1","CAMARONES           ","CHINCHORRO","1","5",3,3,6
"2017",78,"1","PUTRE               ","CHINCHORRO","1","5",122,91,213
"2018",78,"1","PUTRE               ","CHINCHORRO","1","5",172,100,272
"2019",78,"1","PUTRE               ","CHINCHORRO","1","5",125,94,219
"2020",78,"1","PUTRE               ","CHINCHORRO","1","5",126,91,217
"2021",78,"1","PUTRE               ","CHINCHORRO","1","5",135,100,235
"2022",78,"1","PUTRE               ","CHINCHORRO","1","5",138,94,232
"2023",78,"1","PUTRE               ","CHINCHORRO","1","5",143,109,252
"2024",78,"1","PUTRE               ","CHINCHORRO","1","5",137,102,239
"2017",79,"1","PUTRE               ","CHINCHORRO","1","5",13,9,22
"2018",79,"1","PUTRE               ","CHINCHORRO","1","5",8,6,14
"2019",79,"1","PUTRE               ","CHINCHORRO","1","5",12,6,18
"2020",79,"1","PUTRE               ","CHINCHORRO","1","5",5,5,10
"2021",79,"1","PUTRE               ","CHINCHORRO","1","5",3,5,8
"2022",79,"1","PUTRE               ","CHINCHORRO","1","5",3,1,4
"2023",79,"1","PUTRE               ","CHINCHORRO","1","5",4,0,4
"2024",79,"1","PUTRE               ","CHINCHORRO","1","5",6,0,6
"2017",81,"1","PUTRE               ","CHINCHORRO","1","5",3,0,3
"2018",81,"1","PUTRE               ","CHINCHORRO","1","5",2,1,3
"2019",81,"1","PUTRE               ","CHINCHORRO","1","5",2,1,3
"2020",81,"1","PUTRE               ","CHINCHORRO","1","5",3,2,5
"2021",81,"1","PUTRE               ","CHINCHORRO","1","5",1,2,3
"2022",81,"1","PUTRE               ","CHINCHORRO","1","5",1,1,2
"2023",81,"1","PUTRE               ","CHINCHORRO","1","5",3,2,5
"2024",81,"1","PUTRE               ","CHINCHORRO","1","5",2,0,2
"2017",82,"1","PUTRE               ","CHINCHORRO","1","5",2,0,2
"2018",82,"1","PUTRE               ","CHINCHORRO","1","5",2,0,2
"2019",82,"1","PUTRE               ","CHINCHORRO","1","5",2,0,2
"2020",82,"1","PUTRE               ","CHINCHORRO","1","5",1,0,1
"2021",82,"1","PUTRE               ","CHINCHORRO","1","5",1,0,1
"2022",82,"1","PUTRE               ","CHINCHORRO","1","5",1,0,1
"2023",82,"1","PUTRE               ","CHINCHORRO","1","5",2,3,5
"2024",82,"1","PUTRE               ","CHINCHORRO","1","5",0,3,3
"2017",84,"1","PUTRE               ","CHINCHORRO","1","5",2,2,4
"2018",84,"1","PUTRE               ","CHINCHORRO","1","5",1,0,1
"2019",84,"1","PUTRE               ","CHINCHORRO","1","5",1,0,1
"2020",84,"1","PUTRE               ","CHINCHORRO","1","5",2,0,2
"2021",84,"1","PUTRE               ","CHINCHORRO","1","5",2,0,2
"2022",84,"1","PUTRE               ","CHINCHORRO","1","5",1,2,3
"2023",84,"1","PUTRE               ","CHINCHORRO","1","5",1,3,4
"2024",84,"1","PUTRE               ","CHINCHORRO","1","5",1,2,3
"2017",86,"1","PUTRE               ","CHINCHORRO","1","5",3,1,4
"2018",86,"1","PUTRE               ","CHINCHORRO","1","5",5,5,10
"2019",86,"1","PUTRE               ","CHINCHORRO","1","5",4,4,8
"2020",86,"1","PUTRE               ","CHINCHORRO","1","5",3,6,9
"2021",86,"1","PUTRE               ","CHINCHORRO","1","5",2,6,8
"2022",86,"1","PUTRE               ","CHINCHORRO","1","5",2,5,7
"2023",86,"1","PUTRE               ","CHINCHORRO","1","5",2,5,7
"2024",86,"1","PUTRE               ","CHINCHORRO","1","5",1,3,4
"2017",87,"1","GENERAL LAGOS       ","CHINCHORRO","1","5",1,0,1
"2018",87,"1","GENERAL LAGOS       ","CHINCHORRO","1","5",1,0,1
"2019",87,"1","GENERAL LAGOS       ","CHINCHORRO","1","5",0,1,1
"2020",87,"1","GENERAL LAGOS       ","CHINCHORRO","1","5",1,2,3
"2021",87,"1","GENERAL LAGOS       ","CHINCHORRO","1","5",1,2,3
"2022",87,"1","GENERAL LAGOS       ","CHINCHORRO","1","5",2,2,4
"2023",87,"1","GENERAL LAGOS       ","CHINCHORRO","1","5",3,2,5
"2024",87,"1","GENERAL LAGOS       ","CHINCHORRO","1","5",3,1,4
"2017",89,"1","GENERAL LAGOS       ","CHINCHORRO","1","5",1,0,1
"2018",89,"1","GENERAL LAGOS       ","CHINCHORRO","1","5",1,1,2
"2019",89,"1","GENERAL LAGOS       ","CHINCHORRO","1","5",1,0,1
"2020",89,"1","GENERAL LAGOS       ","CHINCHORRO","1","5",1,0,1
"2021",89,"1","GENERAL LAGOS       ","CHINCHORRO","1","5",1,0,1
"2022",89,"1","GENERAL LAGOS       ","CHINCHORRO","1","5",2,0,2
"2023",89,"1","GENERAL LAGOS       ","CHINCHORRO","1","5",3,1,4
"2024",89,"1","GENERAL LAGOS       ","CHINCHORRO","1","5",3,1,4
"2017",90,"1","GENERAL LAGOS       ","CHINCHORRO","1","5",14,12,26
"2018",90,"1","GENERAL LAGOS       ","CHINCHORRO","1","5",13,15,28
"2019",90,"1","GENERAL LAGOS       ","CHINCHORRO","1","5",17,13,30
"2020",90,"1","GENERAL LAGOS       ","CHINCHORRO","1","5",13,16,29
"2021",90,"1","GENERAL LAGOS       ","CHINCHORRO","1","5",15,17,32
"2022",90,"1","GENERAL LAGOS       ","CHINCHORRO","1","5",17,19,36
"2023",90,"1","GENERAL LAGOS       ","CHINCHORRO","1","5",19,18,37
"2024",90,"1","GENERAL LAGOS       ","CHINCHORRO","1","5",30,18,48
"2017",91,"1","GENERAL LAGOS       ","CHINCHORRO","1","5",4,1,5
"2018",91,"1","GENERAL LAGOS       ","CHINCHORRO","1","5",4,1,5
"2019",91,"1","GENERAL LAGOS       ","CHINCHORRO","1","5",3,1,4
"2020",91,"1","GENERAL LAGOS       ","CHINCHORRO","1","5",1,0,1
"2021",91,"1","GENERAL LAGOS       ","CHINCHORRO","1","5",0,2,2
"2022",91,"1","GENERAL LAGOS       ","CHINCHORRO","1","5",2,3,5
"2023",91,"1","GENERAL LAGOS       ","CHINCHORRO","1","5",3,3,6
"2024",91,"1","GENERAL LAGOS       ","CHINCHORRO","1","5",2,2,4
"2017",92,"1","GENERAL LAGOS       ","CHINCHORRO","1","5",0,1,1
"2018",92,"1","GENERAL LAGOS       ","CHINCHORRO","1","5",1,0,1
"2019",92,"1","GENERAL LAGOS       ","CHINCHORRO","1","5",2,2,4
"2020",92,"1","GENERAL LAGOS       ","CHINCHORRO","1","5",2,1,3
"2021",92,"1","GENERAL LAGOS       ","CHINCHORRO","1","5",2,3,5
"2022",92,"1","GENERAL LAGOS       ","CHINCHORRO","1","5",3,1,4
"2023",92,"1","GENERAL LAGOS       ","CHINCHORRO","1","5",1,1,2
"2024",92,"1","GENERAL LAGOS       ","CHINCHORRO","1","5",3,1,4
"2017",93,"1","GENERAL LAGOS       ","CHINCHORRO","1","5",3,2,5
"2018",93,"1","GENERAL LAGOS       ","CHINCHORRO","1","5",4,2,6
"2019",93,"1","GENERAL LAGOS       ","CHINCHORRO","1","5",4,1,5
"2020",93,"1","GENERAL LAGOS       ","CHINCHORRO","1","5",5,2,7
"2021",93,"1","GENERAL LAGOS       ","CHINCHORRO","1","5",5,2,7
"2022",93,"1","GENERAL LAGOS       ","CHINCHORRO","1","5",4,3,7
"2023",93,"1","GENERAL LAGOS       ","CHINCHORRO","1","5",1,3,4
"2024",93,"1","GENERAL LAGOS       ","CHINCHORRO","1","5",0,5,5
"2017",94,"1","GENERAL LAGOS       ","CHINCHORRO","1","5",0,1,1
"2018",94,"1","GENERAL LAGOS       ","CHINCHORRO","1","5",3,1,4
"2019",94,"1","GENERAL LAGOS       ","CHINCHORRO","1","5",3,0,3
"2020",94,"1","GENERAL LAGOS       ","CHINCHORRO","1","5",6,2,8
"2021",94,"1","GENERAL LAGOS       ","CHINCHORRO","1","5",5,1,6
"2022",94,"1","GENERAL LAGOS       ","CHINCHORRO","1","5",3,2,5
"2023",94,"1","GENERAL LAGOS       ","CHINCHORRO","1","5",2,2,4
"2024",94,"1","GENERAL LAGOS       ","CHINCHORRO","1","5",2,5,7
"2017",95,"1","GENERAL LAGOS       ","CHINCHORRO","1","5",0,1,1
"2018",95,"1","GENERAL LAGOS       ","CHINCHORRO","1","5",0,1,1
"2019",95,"1","GENERAL LAGOS       ","CHINCHORRO","1","5",0,2,2
"2020",95,"1","GENERAL LAGOS       ","CHINCHORRO","1","5",0,2,2
"2021",95,"1","GENERAL LAGOS       ","CHINCHORRO","1","5",0,1,1
"2022",95,"1","GENERAL LAGOS       ","CHINCHORRO","1","5",0,1,1
"2023",95,"1","GENERAL LAGOS       ","CHINCHORRO","1","5",0,1,1
"2024",95,"1","GENERAL LAGOS       ","CHINCHORRO","1","5",0,1,1
"2017",448,"0","VALLENAR            ","HUASCO","1","1",340,375,715
"2018",448,"0","VALLENAR            ","HUASCO","1","1",366,400,766
"2019",448,"0","VALLENAR            ","HUASCO","1","1",359,403,762
"2020",448,"0","VALLENAR            ","HUASCO","1","1",356,408,764
"2021",448,"0","VALLENAR            ","HUASCO","1","1",374,444,818
"2022",448,"0","VALLENAR            ","HUASCO","1","1",395,464,859
"2023",448,"0","VALLENAR            ","HUASCO","1","1",420,459,879
"2024",448,"0","VALLENAR            ","HUASCO","1","1",423,455,878
"2017",449,"0","VALLENAR            ","HUASCO","1","1",531,154,685
"2018",449,"0","VALLENAR            ","HUASCO","1","1",472,106,578
"2019",449,"0","VALLENAR            ","HUASCO","1","1",481,121,602
"2020",449,"0","VALLENAR            ","HUASCO","1","1",501,136,637
"2021",449,"0","VALLENAR            ","HUASCO","1","1",537,141,678
"2022",449,"0","VALLENAR            ","HUASCO","1","1",555,149,704
"2023",449,"0","VALLENAR            ","HUASCO","1","1",463,154,617
"2024",449,"0","VALLENAR            ","HUASCO","1","1",466,165,631
"2017",450,"0","VALLENAR            ","HUASCO","1","1",117,109,226
"2018",450,"0","VALLENAR            ","HUASCO","1","1",116,103,219
"2019",450,"0","VALLENAR            ","HUASCO","1","1",120,106,226
"2020",450,"0","VALLENAR            ","HUASCO","1","1",122,111,233
"2021",450,"0","VALLENAR            ","HUASCO","1","1",134,123,257
"2022",450,"0","VALLENAR            ","HUASCO","1","1",150,139,289
"2023",450,"0","VALLENAR            ","HUASCO","1","1",139,137,276
"2024",450,"0","VALLENAR            ","HUASCO","1","1",148,142,290
"2017",452,"0","VALLENAR            ","HUASCO","1","1",195,192,387
"2018",452,"0","VALLENAR            ","HUASCO","1","1",204,185,389
"2019",452,"0","VALLENAR            ","HUASCO","1","1",196,192,388
"2020",452,"0","VALLENAR            ","HUASCO","1","1",202,197,399
"2021",452,"0","VALLENAR            ","HUASCO","1","1",200,196,396
"2022",452,"0","VALLENAR            ","HUASCO","1","1",203,195,398
"2023",452,"0","VALLENAR            ","HUASCO","1","1",198,201,399
"2024",452,"0","VALLENAR            ","HUASCO","1","1",195,193,388
"2017",453,"0","VALLENAR            ","HUASCO","1","1",421,341,762
"2018",453,"0","VALLENAR            ","HUASCO","1","1",422,345,767
"2019",453,"0","VALLENAR            ","HUASCO","1","1",417,349,766
"2020",453,"0","VALLENAR            ","HUASCO","1","1",413,352,765
"2021",453,"0","VALLENAR            ","HUASCO","1","1",409,351,760
"2022",453,"0","VALLENAR            ","HUASCO","1","1",381,363,744
"2023",453,"0","VALLENAR            ","HUASCO","1","1",380,385,765
"2024",453,"0","VALLENAR            ","HUASCO","1","1",382,372,754
"2017",454,"0","VALLENAR            ","HUASCO","1","1",443,409,852
"2018",454,"0","VALLENAR            ","HUASCO","1","1",458,409,867
"2019",454,"0","VALLENAR            ","HUASCO","1","1",489,424,913
"2020",454,"0","VALLENAR            ","HUASCO","1","1",493,427,920
"2021",454,"0","VALLENAR            ","HUASCO","1","1",477,416,893
"2022",454,"0","VALLENAR            ","HUASCO","1","1",479,452,931
"2023",454,"0","VALLENAR            ","HUASCO","1","1",490,447,937
"2024",454,"0","VALLENAR            ","HUASCO","1","1",475,408,883
"2017",455,"0","VALLENAR            ","HUASCO","1","1",168,156,324
"2018",455,"0","VALLENAR            ","HUASCO","1","1",160,155,315
"2019",455,"0","VALLENAR            ","HUASCO","1","1",183,163,346
"2020",455,"0","VALLENAR            ","HUASCO","1","1",184,168,352
"2021",455,"0","VALLENAR            ","HUASCO","1","1",182,166,348
"2022",455,"0","VALLENAR            ","HUASCO","1","1",178,166,344
"2023",455,"0","VALLENAR            ","HUASCO","1","1",187,170,357
"2024",455,"0","VALLENAR            ","HUASCO","1","1",180,173,353
"2017",456,"0","VALLENAR            ","HUASCO","1","1",53,34,87
"2018",456,"0","VALLENAR            ","HUASCO","1","1",47,37,84
"2019",456,"0","VALLENAR            ","HUASCO","1","1",56,33,89
"2020",456,"0","VALLENAR            ","HUASCO","1","1",62,34,96
"2021",456,"0","VALLENAR            ","HUASCO","1","1",60,35,95
"2022",456,"0","VALLENAR            ","HUASCO","1","1",59,31,90
"2023",456,"0","VALLENAR            ","HUASCO","1","1",65,32,97
"2024",456,"0","VALLENAR            ","HUASCO","1","1",74,30,104
"2017",458,"0","VALLENAR            ","HUASCO","1","1",173,138,311
"2018",458,"0","VALLENAR            ","HUASCO","1","1",185,162,347
"2019",458,"0","VALLENAR            ","HUASCO","1","1",181,146,327
"2020",458,"0","VALLENAR            ","HUASCO","1","1",189,148,337
"2021",458,"0","VALLENAR            ","HUASCO","1","1",183,145,328
"2022",458,"0","VALLENAR            ","HUASCO","1","1",195,159,354
"2023",458,"0","VALLENAR            ","HUASCO","1","1",186,151,337
"2024",458,"0","VALLENAR            ","HUASCO","1","1",193,151,344
"2017",459,"0","VALLENAR            ","HUASCO","1","1",366,318,684
"2018",459,"0","VALLENAR            ","HUASCO","1","1",376,314,690
"2019",459,"0","VALLENAR            ","HUASCO","1","1",352,309,661
"2020",459,"0","VALLENAR            ","HUASCO","1","1",335,296,631
"2021",459,"0","VALLENAR            ","HUASCO","1","1",338,260,598
"2022",459,"0","VALLENAR            ","HUASCO","1","1",302,250,552
"2023",459,"0","VALLENAR            ","HUASCO","1","1",291,246,537
"2024",459,"0","VALLENAR            ","HUASCO","1","1",257,213,470
"2017",461,"0","VALLENAR            ","HUASCO","1","1",152,135,287
"2018",461,"0","VALLENAR            ","HUASCO","1","1",172,160,332
"2019",461,"0","VALLENAR            ","HUASCO","1","1",172,156,328
"2020",461,"0","VALLENAR            ","HUASCO","1","1",164,164,328
"2021",461,"0","VALLENAR            ","HUASCO","1","1",165,160,325
"2022",461,"0","VALLENAR            ","HUASCO","1","1",167,149,316
"2023",461,"0","VALLENAR            ","HUASCO","1","1",166,138,304
"2024",461,"0","VALLENAR            ","HUASCO","1","1",178,133,311
"2017",462,"0","VALLENAR            ","HUASCO","1","1",172,157,329
"2018",462,"0","VALLENAR            ","HUASCO","1","1",184,172,356
"2019",462,"0","VALLENAR            ","HUASCO","1","1",181,189,370
"2020",462,"0","VALLENAR            ","HUASCO","1","1",181,204,385
"2021",462,"0","VALLENAR            ","HUASCO","1","1",181,201,382
"2022",462,"0","VALLENAR            ","HUASCO","1","1",172,202,374
"2023",462,"0","VALLENAR            ","HUASCO","1","1",184,200,384
"2024",462,"0","VALLENAR            ","HUASCO","1","1",182,195,377
"2017",463,"0","VALLENAR            ","HUASCO","1","1",81,74,155
"2018",463,"0","VALLENAR            ","HUASCO","1","1",86,69,155
"2019",463,"0","VALLENAR            ","HUASCO","1","1",78,66,144
"2020",463,"0","VALLENAR            ","HUASCO","1","1",74,67,141
"2021",463,"0","VALLENAR            ","HUASCO","1","1",78,71,149
"2022",463,"0","VALLENAR            ","HUASCO","1","1",78,65,143
"2023",463,"0","VALLENAR            ","HUASCO","1","1",72,65,137
"2024",463,"0","VALLENAR            ","HUASCO","1","1",69,57,126
"2017",464,"0","VALLENAR            ","HUASCO","1","1",356,304,660
"2018",464,"0","VALLENAR            ","HUASCO","1","1",338,294,632
"2019",464,"0","VALLENAR            ","HUASCO","1","1",333,304,637
"2020",464,"0","VALLENAR            ","HUASCO","1","1",341,297,638
"2021",464,"0","VALLENAR            ","HUASCO","1","1",331,291,622
"2022",464,"0","VALLENAR            ","HUASCO","1","1",331,318,649
"2023",464,"0","VALLENAR            ","HUASCO","1","1",353,320,673
"2024",464,"0","VALLENAR            ","HUASCO","1","1",313,300,613
"2017",467,"1","VALLENAR            ","HUASCO","1","1",6,6,12
"2018",467,"1","VALLENAR            ","HUASCO","1","1",6,3,9
"2019",467,"1","VALLENAR            ","HUASCO","1","1",12,6,18
"2020",467,"1","VALLENAR            ","HUASCO","1","1",9,6,15
"2021",467,"1","VALLENAR            ","HUASCO","1","1",8,7,15
"2022",467,"1","VALLENAR            ","HUASCO","1","1",3,5,8
"2023",467,"1","VALLENAR            ","HUASCO","1","1",3,4,7
"2024",467,"1","VALLENAR            ","HUASCO","1","1",1,4,5
"2017",468,"1","VALLENAR            ","HUASCO","1","1",9,7,16
"2018",468,"1","VALLENAR            ","HUASCO","1","1",9,10,19
"2019",468,"1","VALLENAR            ","HUASCO","1","1",11,10,21
"2020",468,"1","VALLENAR            ","HUASCO","1","1",13,8,21
"2021",468,"1","VALLENAR            ","HUASCO","1","1",11,14,25
"2022",468,"1","VALLENAR            ","HUASCO","1","1",9,9,18
"2023",468,"1","VALLENAR            ","HUASCO","1","1",8,9,17
"2024",468,"1","VALLENAR            ","HUASCO","1","1",9,10,19
"2017",469,"1","VALLENAR            ","HUASCO","1","1",23,17,40
"2018",469,"1","VALLENAR            ","HUASCO","1","1",25,17,42
"2019",469,"1","VALLENAR            ","HUASCO","1","1",14,18,32
"2020",469,"1","VALLENAR            ","HUASCO","1","1",15,20,35
"2021",469,"1","VALLENAR            ","HUASCO","1","1",13,24,37
"2022",469,"1","VALLENAR            ","HUASCO","1","1",18,23,41
"2023",469,"1","VALLENAR            ","HUASCO","1","1",20,26,46
"2024",469,"1","VALLENAR            ","HUASCO","1","1",21,19,40
"2017",471,"1","VALLENAR            ","HUASCO","1","1",15,13,28
"2018",471,"1","VALLENAR            ","HUASCO","1","1",23,22,45
"2019",471,"1","VALLENAR            ","HUASCO","1","1",22,29,51
"2020",471,"1","VALLENAR            ","HUASCO","1","1",33,30,63
"2021",471,"1","VALLENAR            ","HUASCO","1","1",44,35,79
"2022",471,"1","VALLENAR            ","HUASCO","1","1",42,34,76
"2023",471,"1","VALLENAR            ","HUASCO","1","1",36,36,72
"2024",471,"1","VALLENAR            ","HUASCO","1","1",32,29,61
"2017",476,"1","VALLENAR            ","HUASCO","1","1",30,33,63
"2018",476,"1","VALLENAR            ","HUASCO","1","1",33,35,68
"2019",476,"1","VALLENAR            ","HUASCO","1","1",37,36,73
"2020",476,"1","VALLENAR            ","HUASCO","1","1",39,40,79
"2021",476,"1","VALLENAR            ","HUASCO","1","1",44,38,82
"2022",476,"1","VALLENAR            ","HUASCO","1","1",41,38,79
"2023",476,"1","VALLENAR            ","HUASCO","1","1",40,40,80
"2024",476,"1","VALLENAR            ","HUASCO","1","1",35,36,71
"2017",481,"0","FREIRINA            ","HUASCO","1","1",219,233,452
"2018",481,"0","FREIRINA            ","HUASCO","1","1",212,224,436
"2019",481,"0","FREIRINA            ","HUASCO","1","1",212,232,444
"2020",481,"0","FREIRINA            ","HUASCO","1","1",214,233,447
"2021",481,"0","FREIRINA            ","HUASCO","1","1",212,220,432
"2022",481,"0","FREIRINA            ","HUASCO","1","1",209,197,406
"2023",481,"0","FREIRINA            ","HUASCO","1","1",204,200,404
"2024",481,"0","FREIRINA            ","HUASCO","1","1",181,189,370
"2017",482,"1","FREIRINA            ","HUASCO","1","1",8,7,15
"2018",482,"1","FREIRINA            ","HUASCO","1","1",7,7,14
"2019",482,"1","FREIRINA            ","HUASCO","1","1",8,8,16
"2020",482,"1","FREIRINA            ","HUASCO","1","1",14,9,23
"2021",482,"1","FREIRINA            ","HUASCO","1","1",15,12,27
"2022",482,"1","FREIRINA            ","HUASCO","1","1",15,12,27
"2023",482,"1","FREIRINA            ","HUASCO","1","1",25,25,50
"2024",482,"1","FREIRINA            ","HUASCO","1","1",30,24,54
"2017",483,"1","FREIRINA            ","HUASCO","1","1",21,10,31
"2018",483,"1","FREIRINA            ","HUASCO","1","1",24,11,35
"2019",483,"1","FREIRINA            ","HUASCO","1","1",25,11,36
"2020",483,"1","FREIRINA            ","HUASCO","1","1",24,14,38
"2021",483,"1","FREIRINA            ","HUASCO","1","1",25,16,41
"2022",483,"1","FREIRINA            ","HUASCO","1","1",20,18,38
"2023",483,"1","FREIRINA            ","HUASCO","1","1",25,18,43
"2024",483,"1","FREIRINA            ","HUASCO","1","1",28,26,54
"2017",484,"1","FREIRINA            ","HUASCO","1","1",30,25,55
"2018",484,"1","FREIRINA            ","HUASCO","1","1",31,27,58
"2019",484,"1","FREIRINA            ","HUASCO","1","1",26,31,57
"2020",484,"1","FREIRINA            ","HUASCO","1","1",30,33,63
"2021",484,"1","FREIRINA            ","HUASCO","1","1",28,39,67
"2022",484,"1","FREIRINA            ","HUASCO","1","1",31,48,79
"2023",484,"1","FREIRINA            ","HUASCO","1","1",38,46,84
"2024",484,"1","FREIRINA            ","HUASCO","1","1",31,44,75
"2017",485,"1","VALLENAR            ","HUASCO","1","1",6,8,14
"2018",485,"1","VALLENAR            ","HUASCO","1","1",4,6,10
"2019",485,"1","VALLENAR            ","HUASCO","1","1",6,4,10
"2020",485,"1","VALLENAR            ","HUASCO","1","1",5,5,10
"2021",485,"1","VALLENAR            ","HUASCO","1","1",4,4,8
"2022",485,"1","VALLENAR            ","HUASCO","1","1",7,3,10
"2023",485,"1","VALLENAR            ","HUASCO","1","1",8,5,13
"2024",485,"1","VALLENAR            ","HUASCO","1","1",8,8,16
"2017",486,"0","HUASCO              ","HUASCO","1","1",264,187,451
"2018",486,"0","HUASCO              ","HUASCO","1","1",259,197,456
"2019",486,"0","HUASCO              ","HUASCO","1","1",245,174,419
"2020",486,"0","HUASCO              ","HUASCO","1","1",254,163,417
"2021",486,"0","HUASCO              ","HUASCO","1","1",264,165,429
"2022",486,"0","HUASCO              ","HUASCO","1","1",277,185,462
"2023",486,"0","HUASCO              ","HUASCO","1","1",282,214,496
"2024",486,"0","HUASCO              ","HUASCO","1","1",276,232,508
"2017",487,"0","HUASCO              ","HUASCO","1","1",219,215,434
"2018",487,"0","HUASCO              ","HUASCO","1","1",230,226,456
"2019",487,"0","HUASCO              ","HUASCO","1","1",227,210,437
"2020",487,"0","HUASCO              ","HUASCO","1","1",189,193,382
"2021",487,"0","HUASCO              ","HUASCO","1","1",200,209,409
"2022",487,"0","HUASCO              ","HUASCO","1","1",188,193,381
"2023",487,"0","HUASCO              ","HUASCO","1","1",199,195,394
"2024",487,"0","HUASCO              ","HUASCO","1","1",195,196,391
"2017",489,"0","HUASCO              ","HUASCO","1","1",201,176,377
"2018",489,"0","HUASCO              ","HUASCO","1","1",215,191,406
"2019",489,"0","HUASCO              ","HUASCO","1","1",210,188,398
"2020",489,"0","HUASCO              ","HUASCO","1","1",194,192,386
"2021",489,"0","HUASCO              ","HUASCO","1","1",191,186,377
"2022",489,"0","HUASCO              ","HUASCO","1","1",187,190,377
"2023",489,"0","HUASCO              ","HUASCO","1","1",181,185,366
"2024",489,"0","HUASCO              ","HUASCO","1","1",192,185,377
"2017",490,"1","HUASCO              ","HUASCO","1","1",7,6,13
"2018",490,"1","HUASCO              ","HUASCO","1","1",10,7,17
"2019",490,"1","HUASCO              ","HUASCO","1","1",13,10,23
"2020",490,"1","HUASCO              ","HUASCO","1","1",13,5,18
"2021",490,"1","HUASCO              ","HUASCO","1","1",15,8,23
"2022",490,"1","HUASCO              ","HUASCO","1","1",14,6,20
"2023",490,"1","HUASCO              ","HUASCO","1","1",15,6,21
"2024",490,"1","HUASCO              ","HUASCO","1","1",6,7,13
"2017",493,"1","ALTO DEL CARMEN     ","HUASCO","1","1",105,103,208
"2018",493,"1","ALTO DEL CARMEN     ","HUASCO","1","1",106,101,207
"2019",493,"1","ALTO DEL CARMEN     ","HUASCO","1","1",114,99,213
"2020",493,"1","ALTO DEL CARMEN     ","HUASCO","1","1",104,103,207
"2021",493,"1","ALTO DEL CARMEN     ","HUASCO","1","1",103,98,201
"2022",493,"1","ALTO DEL CARMEN     ","HUASCO","1","1",90,99,189
"2023",493,"1","ALTO DEL CARMEN     ","HUASCO","1","1",97,99,196
"2024",493,"1","ALTO DEL CARMEN     ","HUASCO","1","1",101,85,186
"2017",495,"1","ALTO DEL CARMEN     ","HUASCO","1","1",7,5,12
"2018",495,"1","ALTO DEL CARMEN     ","HUASCO","1","1",4,5,9
"2019",495,"1","ALTO DEL CARMEN     ","HUASCO","1","1",5,5,10
"2020",495,"1","ALTO DEL CARMEN     ","HUASCO","1","1",7,4,11
"2021",495,"1","ALTO DEL CARMEN     ","HUASCO","1","1",6,2,8
"2022",495,"1","ALTO DEL CARMEN     ","HUASCO","1","1",8,3,11
"2023",495,"1","ALTO DEL CARMEN     ","HUASCO","1","1",7,5,12
"2024",495,"1","ALTO DEL CARMEN     ","HUASCO","1","1",4,5,9
"2017",496,"1","ALTO DEL CARMEN     ","HUASCO","1","1",5,8,13
"2018",496,"1","ALTO DEL CARMEN     ","HUASCO","1","1",8,8,16
"2019",496,"1","ALTO DEL CARMEN     ","HUASCO","1","1",9,7,16
"2020",496,"1","ALTO DEL CARMEN     ","HUASCO","1","1",7,7,14
"2021",496,"1","ALTO DEL CARMEN     ","HUASCO","1","1",9,9,18
"2022",496,"1","ALTO DEL CARMEN     ","HUASCO","1","1",11,10,21
"2023",496,"1","ALTO DEL CARMEN     ","HUASCO","1","1",11,5,16
"2024",496,"1","ALTO DEL CARMEN     ","HUASCO","1","1",7,6,13
"2017",497,"1","ALTO DEL CARMEN     ","HUASCO","1","1",4,3,7
"2018",497,"1","ALTO DEL CARMEN     ","HUASCO","1","1",4,7,11
"2019",497,"1","ALTO DEL CARMEN     ","HUASCO","1","1",3,4,7
"2020",497,"1","ALTO DEL CARMEN     ","HUASCO","1","1",6,4,10
"2021",497,"1","ALTO DEL CARMEN     ","HUASCO","1","1",6,6,12
"2022",497,"1","ALTO DEL CARMEN     ","HUASCO","1","1",6,6,12
"2023",497,"1","ALTO DEL CARMEN     ","HUASCO","1","1",6,7,13
"2024",497,"1","ALTO DEL CARMEN     ","HUASCO","1","1",6,4,10
"2017",498,"1","ALTO DEL CARMEN     ","HUASCO","1","1",2,1,3
"2018",498,"1","ALTO DEL CARMEN     ","HUASCO","1","1",0,2,2
"2019",498,"1","ALTO DEL CARMEN     ","HUASCO","1","1",0,1,1
"2020",498,"1","ALTO DEL CARMEN     ","HUASCO","1","1",1,2,3
"2021",498,"1","ALTO DEL CARMEN     ","HUASCO","1","1",1,3,4
"2022",498,"1","ALTO DEL CARMEN     ","HUASCO","1","1",1,1,2
"2023",498,"1","ALTO DEL CARMEN     ","HUASCO","1","1",1,1,2
"2024",498,"1","ALTO DEL CARMEN     ","HUASCO","1","1",0,2,2
"2017",499,"1","ALTO DEL CARMEN     ","HUASCO","1","1",116,105,221
"2018",499,"1","ALTO DEL CARMEN     ","HUASCO","1","1",109,109,218
"2019",499,"1","ALTO DEL CARMEN     ","HUASCO","1","1",111,110,221
"2020",499,"1","ALTO DEL CARMEN     ","HUASCO","1","1",108,110,218
"2021",499,"1","ALTO DEL CARMEN     ","HUASCO","1","1",110,109,219
"2022",499,"1","ALTO DEL CARMEN     ","HUASCO","1","1",111,105,216
"2023",499,"1","ALTO DEL CARMEN     ","HUASCO","1","1",113,98,211
"2024",499,"1","ALTO DEL CARMEN     ","HUASCO","1","1",104,99,203
"2017",500,"1","ALTO DEL CARMEN     ","HUASCO","1","1",6,8,14
"2018",500,"1","ALTO DEL CARMEN     ","HUASCO","1","1",5,3,8
"2019",500,"1","ALTO DEL CARMEN     ","HUASCO","1","1",6,2,8
"2020",500,"1","ALTO DEL CARMEN     ","HUASCO","1","1",0,1,1
"2021",500,"1","ALTO DEL CARMEN     ","HUASCO","1","1",1,1,2
"2022",500,"1","ALTO DEL CARMEN     ","HUASCO","1","1",1,1,2
"2023",500,"1","ALTO DEL CARMEN     ","HUASCO","1","1",3,1,4
"2024",500,"1","ALTO DEL CARMEN     ","HUASCO","1","1",4,3,7
"2017",502,"1","ALTO DEL CARMEN     ","HUASCO","1","1",5,4,9
"2018",502,"1","ALTO DEL CARMEN     ","HUASCO","1","1",5,7,12
"2019",502,"1","ALTO DEL CARMEN     ","HUASCO","1","1",3,2,5
"2020",502,"1","ALTO DEL CARMEN     ","HUASCO","1","1",1,1,2
"2021",502,"1","ALTO DEL CARMEN     ","HUASCO","1","1",1,2,3
"2022",502,"1","ALTO DEL CARMEN     ","HUASCO","1","1",4,2,6
"2023",502,"1","ALTO DEL CARMEN     ","HUASCO","1","1",4,4,8
"2024",502,"1","ALTO DEL CARMEN     ","HUASCO","1","1",3,3,6
"2017",503,"1","ALTO DEL CARMEN     ","HUASCO","1","1",2,1,3
"2018",503,"1","ALTO DEL CARMEN     ","HUASCO","1","1",2,1,3
"2019",503,"1","ALTO DEL CARMEN     ","HUASCO","1","1",2,2,4
"2020",503,"1","ALTO DEL CARMEN     ","HUASCO","1","1",2,1,3
"2021",503,"1","ALTO DEL CARMEN     ","HUASCO","1","1",3,2,5
"2022",503,"1","ALTO DEL CARMEN     ","HUASCO","1","1",3,1,4
"2023",503,"1","ALTO DEL CARMEN     ","HUASCO","1","1",5,1,6
"2024",503,"1","ALTO DEL CARMEN     ","HUASCO","1","1",5,1,6
"2017",504,"1","ALTO DEL CARMEN     ","HUASCO","1","1",7,4,11
"2018",504,"1","ALTO DEL CARMEN     ","HUASCO","1","1",4,7,11
"2019",504,"1","ALTO DEL CARMEN     ","HUASCO","1","1",7,6,13
"2020",504,"1","ALTO DEL CARMEN     ","HUASCO","1","1",7,5,12
"2021",504,"1","ALTO DEL CARMEN     ","HUASCO","1","1",8,9,17
"2022",504,"1","ALTO DEL CARMEN     ","HUASCO","1","1",8,12,20
"2023",504,"1","ALTO DEL CARMEN     ","HUASCO","1","1",10,8,18
"2024",504,"1","ALTO DEL CARMEN     ","HUASCO","1","1",6,8,14
"2017",508,"1","ALTO DEL CARMEN     ","HUASCO","1","1",5,5,10
"2018",508,"1","ALTO DEL CARMEN     ","HUASCO","1","1",1,2,3
"2019",508,"1","ALTO DEL CARMEN     ","HUASCO","1","1",1,3,4
"2020",508,"1","ALTO DEL CARMEN     ","HUASCO","1","1",0,1,1
"2021",508,"1","ALTO DEL CARMEN     ","HUASCO","1","1",0,3,3
"2022",508,"1","ALTO DEL CARMEN     ","HUASCO","1","1",3,6,9
"2023",508,"1","ALTO DEL CARMEN     ","HUASCO","1","1",0,6,6
"2024",508,"1","ALTO DEL CARMEN     ","HUASCO","1","1",0,5,5
"2017",514,"1","ALTO DEL CARMEN     ","HUASCO","1","1",2,4,6
"2018",514,"1","ALTO DEL CARMEN     ","HUASCO","1","1",3,4,7
"2019",514,"1","ALTO DEL CARMEN     ","HUASCO","1","1",2,6,8
"2020",514,"1","ALTO DEL CARMEN     ","HUASCO","1","1",3,6,9
"2021",514,"1","ALTO DEL CARMEN     ","HUASCO","1","1",6,8,14
"2022",514,"1","ALTO DEL CARMEN     ","HUASCO","1","1",4,6,10
"2023",514,"1","ALTO DEL CARMEN     ","HUASCO","1","1",4,3,7
"2024",514,"1","ALTO DEL CARMEN     ","HUASCO","1","1",2,3,5
"2017",609,"0","COQUIMBO            ","PUERTO CORDILLERA","1","2",274,444,718
"2018",609,"0","COQUIMBO            ","PUERTO CORDILLERA","1","2",287,406,693
"2019",609,"0","COQUIMBO            ","PUERTO CORDILLERA","1","2",311,402,713
"2020",609,"0","COQUIMBO            ","PUERTO CORDILLERA","1","2",345,381,726
"2021",609,"0","COQUIMBO            ","PUERTO CORDILLERA","1","2",374,391,765
"2022",609,"0","COQUIMBO            ","PUERTO CORDILLERA","1","2",403,397,800
"2023",609,"0","COQUIMBO            ","PUERTO CORDILLERA","1","2",420,395,815
"2024",609,"0","COQUIMBO            ","PUERTO CORDILLERA","1","2",444,394,838
"2017",610,"0","COQUIMBO            ","PUERTO CORDILLERA","1","2",747,79,826
"2018",610,"0","COQUIMBO            ","PUERTO CORDILLERA","1","2",662,89,751
"2019",610,"0","COQUIMBO            ","PUERTO CORDILLERA","1","2",537,75,612
"2020",610,"0","COQUIMBO            ","PUERTO CORDILLERA","1","2",427,56,483
"2021",610,"0","COQUIMBO            ","PUERTO CORDILLERA","1","2",351,55,406
"2022",610,"0","COQUIMBO            ","PUERTO CORDILLERA","1","2",338,84,422
"2023",610,"0","COQUIMBO            ","PUERTO CORDILLERA","1","2",403,93,496
"2024",610,"0","COQUIMBO            ","PUERTO CORDILLERA","1","2",431,116,547
"2017",611,"0","COQUIMBO            ","PUERTO CORDILLERA","1","2",171,192,363
"2018",611,"0","COQUIMBO            ","PUERTO CORDILLERA","1","2",161,137,298
"2019",611,"0","COQUIMBO            ","PUERTO CORDILLERA","1","2",129,123,252
"2020",611,"0","COQUIMBO            ","PUERTO CORDILLERA","1","2",136,122,258
"2021",611,"0","COQUIMBO            ","PUERTO CORDILLERA","1","2",135,129,264
"2022",611,"0","COQUIMBO            ","PUERTO CORDILLERA","1","2",145,160,305
"2023",611,"0","COQUIMBO            ","PUERTO CORDILLERA","1","2",165,187,352
"2024",611,"0","COQUIMBO            ","PUERTO CORDILLERA","1","2",204,242,446
"2017",612,"0","COQUIMBO            ","PUERTO CORDILLERA","1","2",146,117,263
"2018",612,"0","COQUIMBO            ","PUERTO CORDILLERA","1","2",165,128,293
"2019",612,"0","COQUIMBO            ","PUERTO CORDILLERA","1","2",143,121,264
"2020",612,"0","COQUIMBO            ","PUERTO CORDILLERA","1","2",147,136,283
"2021",612,"0","COQUIMBO            ","PUERTO CORDILLERA","1","2",159,129,288
"2022",612,"0","COQUIMBO            ","PUERTO CORDILLERA","1","2",164,144,308
"2023",612,"0","COQUIMBO            ","PUERTO CORDILLERA","1","2",145,136,281
"2024",612,"0","COQUIMBO            ","PUERTO CORDILLERA","1","2",144,130,274
"2017",613,"0","COQUIMBO            ","PUERTO CORDILLERA","1","2",388,462,850
"2018",613,"0","COQUIMBO            ","PUERTO CORDILLERA","1","2",381,458,839
"2019",613,"0","COQUIMBO            ","PUERTO CORDILLERA","1","2",395,445,840
"2020",613,"0","COQUIMBO            ","PUERTO CORDILLERA","1","2",411,427,838
"2021",613,"0","COQUIMBO            ","PUERTO CORDILLERA","1","2",401,436,837
"2022",613,"0","COQUIMBO            ","PUERTO CORDILLERA","1","2",409,432,841
"2023",613,"0","COQUIMBO            ","PUERTO CORDILLERA","1","2",394,412,806
"2024",613,"0","COQUIMBO            ","PUERTO CORDILLERA","1","2",370,417,787
"2017",614,"0","COQUIMBO            ","PUERTO CORDILLERA","1","2",161,141,302
"2018",614,"0","COQUIMBO            ","PUERTO CORDILLERA","1","2",168,135,303
"2019",614,"0","COQUIMBO            ","PUERTO CORDILLERA","1","2",162,126,288
"2020",614,"0","COQUIMBO            ","PUERTO CORDILLERA","1","2",187,119,306
"2021",614,"0","COQUIMBO            ","PUERTO CORDILLERA","1","2",172,113,285
"2022",614,"0","COQUIMBO            ","PUERTO CORDILLERA","1","2",214,136,350
"2023",614,"0","COQUIMBO            ","PUERTO CORDILLERA","1","2",168,135,303
"2024",614,"0","COQUIMBO            ","PUERTO CORDILLERA","1","2",151,138,289
"2017",615,"0","COQUIMBO            ","PUERTO CORDILLERA","1","2",109,86,195
"2018",615,"0","COQUIMBO            ","PUERTO CORDILLERA","1","2",119,104,223
"2019",615,"0","COQUIMBO            ","PUERTO CORDILLERA","1","2",160,118,278
"2020",615,"0","COQUIMBO            ","PUERTO CORDILLERA","1","2",167,115,282
"2021",615,"0","COQUIMBO            ","PUERTO CORDILLERA","1","2",150,118,268
"2022",615,"0","COQUIMBO            ","PUERTO CORDILLERA","1","2",180,134,314
"2023",615,"0","COQUIMBO            ","PUERTO CORDILLERA","1","2",159,116,275
"2024",615,"0","COQUIMBO            ","PUERTO CORDILLERA","1","2",158,110,268
"2017",616,"0","COQUIMBO            ","PUERTO CORDILLERA","1","2",363,328,691
"2018",616,"0","COQUIMBO            ","PUERTO CORDILLERA","1","2",360,331,691
"2019",616,"0","COQUIMBO            ","PUERTO CORDILLERA","1","2",370,337,707
"2020",616,"0","COQUIMBO            ","PUERTO CORDILLERA","1","2",361,331,692
"2021",616,"0","COQUIMBO            ","PUERTO CORDILLERA","1","2",360,312,672
"2022",616,"0","COQUIMBO            ","PUERTO CORDILLERA","1","2",350,308,658
"2023",616,"0","COQUIMBO            ","PUERTO CORDILLERA","1","2",354,287,641
"2024",616,"0","COQUIMBO            ","PUERTO CORDILLERA","1","2",327,272,599
"2017",617,"0","COQUIMBO            ","PUERTO CORDILLERA","1","2",142,120,262
"2018",617,"0","COQUIMBO            ","PUERTO CORDILLERA","1","2",128,116,244
"2019",617,"0","COQUIMBO            ","PUERTO CORDILLERA","1","2",113,109,222
"2020",617,"0","COQUIMBO            ","PUERTO CORDILLERA","1","2",109,102,211
"2021",617,"0","COQUIMBO            ","PUERTO CORDILLERA","1","2",118,104,222
"2022",617,"0","COQUIMBO            ","PUERTO CORDILLERA","1","2",119,106,225
"2023",617,"0","COQUIMBO            ","PUERTO CORDILLERA","1","2",133,115,248
"2024",617,"0","COQUIMBO            ","PUERTO CORDILLERA","1","2",129,118,247
"2017",618,"0","COQUIMBO            ","PUERTO CORDILLERA","1","2",332,267,599
"2018",618,"0","COQUIMBO            ","PUERTO CORDILLERA","1","2",314,240,554
"2019",618,"0","COQUIMBO            ","PUERTO CORDILLERA","1","2",330,259,589
"2020",618,"0","COQUIMBO            ","PUERTO CORDILLERA","1","2",329,262,591
"2021",618,"0","COQUIMBO            ","PUERTO CORDILLERA","1","2",312,250,562
"2022",618,"0","COQUIMBO            ","PUERTO CORDILLERA","1","2",315,297,612
"2023",618,"0","COQUIMBO            ","PUERTO CORDILLERA","1","2",331,280,611
"2024",618,"0","COQUIMBO            ","PUERTO CORDILLERA","1","2",318,285,603
"2017",620,"0","COQUIMBO            ","PUERTO CORDILLERA","1","2",185,197,382
"2018",620,"0","COQUIMBO            ","PUERTO CORDILLERA","1","2",189,197,386
"2019",620,"0","COQUIMBO            ","PUERTO CORDILLERA","1","2",194,191,385
"2020",620,"0","COQUIMBO            ","PUERTO CORDILLERA","1","2",215,206,421
"2021",620,"0","COQUIMBO            ","PUERTO CORDILLERA","1","2",224,218,442
"2022",620,"0","COQUIMBO            ","PUERTO CORDILLERA","1","2",283,254,537
"2023",620,"0","COQUIMBO            ","PUERTO CORDILLERA","1","2",272,249,521
"2024",620,"0","COQUIMBO            ","PUERTO CORDILLERA","1","2",259,244,503
"2017",621,"0","COQUIMBO            ","PUERTO CORDILLERA","1","2",106,82,188
"2018",621,"0","COQUIMBO            ","PUERTO CORDILLERA","1","2",101,84,185
"2019",621,"0","COQUIMBO            ","PUERTO CORDILLERA","1","2",113,91,204
"2020",621,"0","COQUIMBO            ","PUERTO CORDILLERA","1","2",118,85,203
"2021",621,"0","COQUIMBO            ","PUERTO CORDILLERA","1","2",129,94,223
"2022",621,"0","COQUIMBO            ","PUERTO CORDILLERA","1","2",159,93,252
"2023",621,"0","COQUIMBO            ","PUERTO CORDILLERA","1","2",145,116,261
"2024",621,"0","COQUIMBO            ","PUERTO CORDILLERA","1","2",119,103,222
"2017",623,"0","COQUIMBO            ","PUERTO CORDILLERA","1","2",38,17,55
"2018",623,"0","COQUIMBO            ","PUERTO CORDILLERA","1","2",36,23,59
"2019",623,"0","COQUIMBO            ","PUERTO CORDILLERA","1","2",35,18,53
"2020",623,"0","COQUIMBO            ","PUERTO CORDILLERA","1","2",33,19,52
"2021",623,"0","COQUIMBO            ","PUERTO CORDILLERA","1","2",38,20,58
"2022",623,"0","COQUIMBO            ","PUERTO CORDILLERA","1","2",41,20,61
"2023",623,"0","COQUIMBO            ","PUERTO CORDILLERA","1","2",37,21,58
"2024",623,"0","COQUIMBO            ","PUERTO CORDILLERA","1","2",33,16,49
"2017",624,"0","COQUIMBO            ","PUERTO CORDILLERA","1","2",40,17,57
"2018",624,"0","COQUIMBO            ","PUERTO CORDILLERA","1","2",36,16,52
"2019",624,"0","COQUIMBO            ","PUERTO CORDILLERA","1","2",43,17,60
"2020",624,"0","COQUIMBO            ","PUERTO CORDILLERA","1","2",44,17,61
"2021",624,"0","COQUIMBO            ","PUERTO CORDILLERA","1","2",48,19,67
"2022",624,"0","COQUIMBO            ","PUERTO CORDILLERA","1","2",54,16,70
"2023",624,"0","COQUIMBO            ","PUERTO CORDILLERA","1","2",47,17,64
"2024",624,"0","COQUIMBO            ","PUERTO CORDILLERA","1","2",55,17,72
"2017",625,"0","COQUIMBO            ","PUERTO CORDILLERA","1","2",128,76,204
"2018",625,"0","COQUIMBO            ","PUERTO CORDILLERA","1","2",132,71,203
"2019",625,"0","COQUIMBO            ","PUERTO CORDILLERA","1","2",119,77,196
"2020",625,"0","COQUIMBO            ","PUERTO CORDILLERA","1","2",110,84,194
"2021",625,"0","COQUIMBO            ","PUERTO CORDILLERA","1","2",105,87,192
"2022",625,"0","COQUIMBO            ","PUERTO CORDILLERA","1","2",114,84,198
"2023",625,"0","COQUIMBO            ","PUERTO CORDILLERA","1","2",107,89,196
"2024",625,"0","COQUIMBO            ","PUERTO CORDILLERA","1","2",105,88,193
"2017",626,"0","COQUIMBO            ","PUERTO CORDILLERA","1","2",299,278,577
"2018",626,"0","COQUIMBO            ","PUERTO CORDILLERA","1","2",337,307,644
"2019",626,"0","COQUIMBO            ","PUERTO CORDILLERA","1","2",354,344,698
"2020",626,"0","COQUIMBO            ","PUERTO CORDILLERA","1","2",370,350,720
"2021",626,"0","COQUIMBO            ","PUERTO CORDILLERA","1","2",369,363,732
"2022",626,"0","COQUIMBO            ","PUERTO CORDILLERA","1","2",378,377,755
"2023",626,"0","COQUIMBO            ","PUERTO CORDILLERA","1","2",369,373,742
"2024",626,"0","COQUIMBO            ","PUERTO CORDILLERA","1","2",345,350,695
"2017",628,"0","COQUIMBO            ","PUERTO CORDILLERA","1","2",108,90,198
"2018",628,"0","COQUIMBO            ","PUERTO CORDILLERA","1","2",119,80,199
"2019",628,"0","COQUIMBO            ","PUERTO CORDILLERA","1","2",126,106,232
"2020",628,"0","COQUIMBO            ","PUERTO CORDILLERA","1","2",126,109,235
"2021",628,"0","COQUIMBO            ","PUERTO CORDILLERA","1","2",135,120,255
"2022",628,"0","COQUIMBO            ","PUERTO CORDILLERA","1","2",141,122,263
"2023",628,"0","COQUIMBO            ","PUERTO CORDILLERA","1","2",138,109,247
"2024",628,"0","COQUIMBO            ","PUERTO CORDILLERA","1","2",141,105,246
"2017",629,"1","COQUIMBO            ","PUERTO CORDILLERA","1","2",401,363,764
"2018",629,"1","COQUIMBO            ","PUERTO CORDILLERA","1","2",413,345,758
"2019",629,"1","COQUIMBO            ","PUERTO CORDILLERA","1","2",366,319,685
"2020",629,"1","COQUIMBO            ","PUERTO CORDILLERA","1","2",341,314,655
"2021",629,"1","COQUIMBO            ","PUERTO CORDILLERA","1","2",379,335,714
"2022",629,"1","COQUIMBO            ","PUERTO CORDILLERA","1","2",396,360,756
"2023",629,"1","COQUIMBO            ","PUERTO CORDILLERA","1","2",391,359,750
"2024",629,"1","COQUIMBO            ","PUERTO CORDILLERA","1","2",393,368,761
"2017",630,"0","COQUIMBO            ","PUERTO CORDILLERA","1","2",186,154,340
"2018",630,"0","COQUIMBO            ","PUERTO CORDILLERA","1","2",181,160,341
"2019",630,"0","COQUIMBO            ","PUERTO CORDILLERA","1","2",187,153,340
"2020",630,"0","COQUIMBO            ","PUERTO CORDILLERA","1","2",170,166,336
"2021",630,"0","COQUIMBO            ","PUERTO CORDILLERA","1","2",177,170,347
"2022",630,"0","COQUIMBO            ","PUERTO CORDILLERA","1","2",197,171,368
"2023",630,"0","COQUIMBO            ","PUERTO CORDILLERA","1","2",210,156,366
"2024",630,"0","COQUIMBO            ","PUERTO CORDILLERA","1","2",191,158,349
"2017",631,"0","COQUIMBO            ","PUERTO CORDILLERA","1","2",195,208,403
"2018",631,"0","COQUIMBO            ","PUERTO CORDILLERA","1","2",199,209,408
"2019",631,"0","COQUIMBO            ","PUERTO CORDILLERA","1","2",195,217,412
"2020",631,"0","COQUIMBO            ","PUERTO CORDILLERA","1","2",201,222,423
"2021",631,"0","COQUIMBO            ","PUERTO CORDILLERA","1","2",198,219,417
"2022",631,"0","COQUIMBO            ","PUERTO CORDILLERA","1","2",202,208,410
"2023",631,"0","COQUIMBO            ","PUERTO CORDILLERA","1","2",200,209,409
"2024",631,"0","COQUIMBO            ","PUERTO CORDILLERA","1","2",201,219,420
"2017",632,"0","COQUIMBO            ","PUERTO CORDILLERA","1","2",198,187,385
"2018",632,"0","COQUIMBO            ","PUERTO CORDILLERA","1","2",206,185,391
"2019",632,"0","COQUIMBO            ","PUERTO CORDILLERA","1","2",201,179,380
"2020",632,"0","COQUIMBO            ","PUERTO CORDILLERA","1","2",217,193,410
"2021",632,"0","COQUIMBO            ","PUERTO CORDILLERA","1","2",207,200,407
"2022",632,"0","COQUIMBO            ","PUERTO CORDILLERA","1","2",205,202,407
"2023",632,"0","COQUIMBO            ","PUERTO CORDILLERA","1","2",194,195,389
"2024",632,"0","COQUIMBO            ","PUERTO CORDILLERA","1","2",201,191,392
"2017",634,"1","COQUIMBO            ","PUERTO CORDILLERA","1","2",26,29,55
"2018",634,"1","COQUIMBO            ","PUERTO CORDILLERA","1","2",23,26,49
"2019",634,"1","COQUIMBO            ","PUERTO CORDILLERA","1","2",24,27,51
"2020",634,"1","COQUIMBO            ","PUERTO CORDILLERA","1","2",23,32,55
"2021",634,"1","COQUIMBO            ","PUERTO CORDILLERA","1","2",24,31,55
"2022",634,"1","COQUIMBO            ","PUERTO CORDILLERA","1","2",22,25,47
"2023",634,"1","COQUIMBO            ","PUERTO CORDILLERA","1","2",19,20,39
"2024",634,"1","COQUIMBO            ","PUERTO CORDILLERA","1","2",25,26,51
"2017",635,"1","COQUIMBO            ","PUERTO CORDILLERA","1","2",6,6,12
"2018",635,"1","COQUIMBO            ","PUERTO CORDILLERA","1","2",7,7,14
"2019",635,"1","COQUIMBO            ","PUERTO CORDILLERA","1","2",10,6,16
"2020",635,"1","COQUIMBO            ","PUERTO CORDILLERA","1","2",12,7,19
"2021",635,"1","COQUIMBO            ","PUERTO CORDILLERA","1","2",10,8,18
"2022",635,"1","COQUIMBO            ","PUERTO CORDILLERA","1","2",12,4,16
"2023",635,"1","COQUIMBO            ","PUERTO CORDILLERA","1","2",12,5,17
"2024",635,"1","COQUIMBO            ","PUERTO CORDILLERA","1","2",13,6,19
"2017",637,"0","COQUIMBO            ","PUERTO CORDILLERA","1","2",145,118,263
"2018",637,"0","COQUIMBO            ","PUERTO CORDILLERA","1","2",133,127,260
"2019",637,"0","COQUIMBO            ","PUERTO CORDILLERA","1","2",140,134,274
"2020",637,"0","COQUIMBO            ","PUERTO CORDILLERA","1","2",161,128,289
"2021",637,"0","COQUIMBO            ","PUERTO CORDILLERA","1","2",153,117,270
"2022",637,"0","COQUIMBO            ","PUERTO CORDILLERA","1","2",153,115,268
"2023",637,"0","COQUIMBO            ","PUERTO CORDILLERA","1","2",157,108,265
"2024",637,"0","COQUIMBO            ","PUERTO CORDILLERA","1","2",137,128,265
"2017",639,"1","COQUIMBO            ","PUERTO CORDILLERA","1","2",24,16,40
"2018",639,"1","COQUIMBO            ","PUERTO CORDILLERA","1","2",29,22,51
"2019",639,"1","COQUIMBO            ","PUERTO CORDILLERA","1","2",46,32,78
"2020",639,"1","COQUIMBO            ","PUERTO CORDILLERA","1","2",38,26,64
"2021",639,"1","COQUIMBO            ","PUERTO CORDILLERA","1","2",39,31,70
"2022",639,"1","COQUIMBO            ","PUERTO CORDILLERA","1","2",51,42,93
"2023",639,"1","COQUIMBO            ","PUERTO CORDILLERA","1","2",60,50,110
"2024",639,"1","COQUIMBO            ","PUERTO CORDILLERA","1","2",73,63,136
"2017",641,"1","COQUIMBO            ","PUERTO CORDILLERA","1","2",34,24,58
"2018",641,"1","COQUIMBO            ","PUERTO CORDILLERA","1","2",32,23,55
"2019",641,"1","COQUIMBO            ","PUERTO CORDILLERA","1","2",30,20,50
"2020",641,"1","COQUIMBO            ","PUERTO CORDILLERA","1","2",29,20,49
"2021",641,"1","COQUIMBO            ","PUERTO CORDILLERA","1","2",28,19,47
"2022",641,"1","COQUIMBO            ","PUERTO CORDILLERA","1","2",26,21,47
"2023",641,"1","COQUIMBO            ","PUERTO CORDILLERA","1","2",16,21,37
"2024",641,"1","COQUIMBO            ","PUERTO CORDILLERA","1","2",17,15,32
"2017",642,"1","COQUIMBO            ","PUERTO CORDILLERA","1","2",84,60,144
"2018",642,"1","COQUIMBO            ","PUERTO CORDILLERA","1","2",87,61,148
"2019",642,"1","COQUIMBO            ","PUERTO CORDILLERA","1","2",85,60,145
"2020",642,"1","COQUIMBO            ","PUERTO CORDILLERA","1","2",83,64,147
"2021",642,"1","COQUIMBO            ","PUERTO CORDILLERA","1","2",83,66,149
"2022",642,"1","COQUIMBO            ","PUERTO CORDILLERA","1","2",75,67,142
"2023",642,"1","COQUIMBO            ","PUERTO CORDILLERA","1","2",87,69,156
"2024",642,"1","COQUIMBO            ","PUERTO CORDILLERA","1","2",85,71,156
"2017",643,"1","COQUIMBO            ","PUERTO CORDILLERA","1","2",57,64,121
"2018",643,"1","COQUIMBO            ","PUERTO CORDILLERA","1","2",69,60,129
"2019",643,"1","COQUIMBO            ","PUERTO CORDILLERA","1","2",74,65,139
"2020",643,"1","COQUIMBO            ","PUERTO CORDILLERA","1","2",77,66,143
"2021",643,"1","COQUIMBO            ","PUERTO CORDILLERA","1","2",72,70,142
"2022",643,"1","COQUIMBO            ","PUERTO CORDILLERA","1","2",69,77,146
"2023",643,"1","COQUIMBO            ","PUERTO CORDILLERA","1","2",80,96,176
"2024",643,"1","COQUIMBO            ","PUERTO CORDILLERA","1","2",82,99,181
"2017",644,"1","COQUIMBO            ","PUERTO CORDILLERA","1","2",15,8,23
"2018",644,"1","COQUIMBO            ","PUERTO CORDILLERA","1","2",16,6,22
"2019",644,"1","COQUIMBO            ","PUERTO CORDILLERA","1","2",16,9,25
"2020",644,"1","COQUIMBO            ","PUERTO CORDILLERA","1","2",20,8,28
"2021",644,"1","COQUIMBO            ","PUERTO CORDILLERA","1","2",21,12,33
"2022",644,"1","COQUIMBO            ","PUERTO CORDILLERA","1","2",28,14,42
"2023",644,"1","COQUIMBO            ","PUERTO CORDILLERA","1","2",27,13,40
"2024",644,"1","COQUIMBO            ","PUERTO CORDILLERA","1","2",26,12,38
"2017",645,"1","COQUIMBO            ","PUERTO CORDILLERA","1","2",5,0,5
"2018",645,"1","COQUIMBO            ","PUERTO CORDILLERA","1","2",5,0,5
"2019",645,"1","COQUIMBO            ","PUERTO CORDILLERA","1","2",5,1,6
"2020",645,"1","COQUIMBO            ","PUERTO CORDILLERA","1","2",9,0,9
"2021",645,"1","COQUIMBO            ","PUERTO CORDILLERA","1","2",6,0,6
"2022",645,"1","COQUIMBO            ","PUERTO CORDILLERA","1","2",7,1,8
"2023",645,"1","COQUIMBO            ","PUERTO CORDILLERA","1","2",10,6,16
"2024",645,"1","COQUIMBO            ","PUERTO CORDILLERA","1","2",12,8,20
"2017",656,"0","ANDACOLLO           ","PUERTO CORDILLERA","1","2",181,102,283
"2018",656,"0","ANDACOLLO           ","PUERTO CORDILLERA","1","2",178,101,279
"2019",656,"0","ANDACOLLO           ","PUERTO CORDILLERA","1","2",152,100,252
"2020",656,"0","ANDACOLLO           ","PUERTO CORDILLERA","1","2",153,103,256
"2021",656,"0","ANDACOLLO           ","PUERTO CORDILLERA","1","2",166,114,280
"2022",656,"0","ANDACOLLO           ","PUERTO CORDILLERA","1","2",154,116,270
"2023",656,"0","ANDACOLLO           ","PUERTO CORDILLERA","1","2",154,132,286
"2024",656,"0","ANDACOLLO           ","PUERTO CORDILLERA","1","2",166,144,310
"2017",657,"0","ANDACOLLO           ","PUERTO CORDILLERA","1","2",128,116,244
"2018",657,"0","ANDACOLLO           ","PUERTO CORDILLERA","1","2",121,101,222
"2019",657,"0","ANDACOLLO           ","PUERTO CORDILLERA","1","2",112,94,206
"2020",657,"0","ANDACOLLO           ","PUERTO CORDILLERA","1","2",114,88,202
"2021",657,"0","ANDACOLLO           ","PUERTO CORDILLERA","1","2",116,95,211
"2022",657,"0","ANDACOLLO           ","PUERTO CORDILLERA","1","2",112,92,204
"2023",657,"0","ANDACOLLO           ","PUERTO CORDILLERA","1","2",101,100,201
"2024",657,"0","ANDACOLLO           ","PUERTO CORDILLERA","1","2",96,93,189
"2017",658,"1","ANDACOLLO           ","PUERTO CORDILLERA","1","2",114,123,237
"2018",658,"1","ANDACOLLO           ","PUERTO CORDILLERA","1","2",112,128,240
"2019",658,"1","ANDACOLLO           ","PUERTO CORDILLERA","1","2",118,126,244
"2020",658,"1","ANDACOLLO           ","PUERTO CORDILLERA","1","2",129,131,260
"2021",658,"1","ANDACOLLO           ","PUERTO CORDILLERA","1","2",130,134,264
"2022",658,"1","ANDACOLLO           ","PUERTO CORDILLERA","1","2",131,126,257
"2023",658,"1","ANDACOLLO           ","PUERTO CORDILLERA","1","2",139,130,269
"2024",658,"1","ANDACOLLO           ","PUERTO CORDILLERA","1","2",130,124,254
"2017",659,"1","ANDACOLLO           ","PUERTO CORDILLERA","1","2",3,0,3
"2018",659,"1","ANDACOLLO           ","PUERTO CORDILLERA","1","2",4,4,8
"2019",659,"1","ANDACOLLO           ","PUERTO CORDILLERA","1","2",6,6,12
"2020",659,"1","ANDACOLLO           ","PUERTO CORDILLERA","1","2",4,5,9
"2021",659,"1","ANDACOLLO           ","PUERTO CORDILLERA","1","2",5,6,11
"2022",659,"1","ANDACOLLO           ","PUERTO CORDILLERA","1","2",5,5,10
"2023",659,"1","ANDACOLLO           ","PUERTO CORDILLERA","1","2",6,2,8
"2024",659,"1","ANDACOLLO           ","PUERTO CORDILLERA","1","2",7,2,9
"2017",661,"1","ANDACOLLO           ","PUERTO CORDILLERA","1","2",11,9,20
"2018",661,"1","ANDACOLLO           ","PUERTO CORDILLERA","1","2",8,10,18
"2019",661,"1","ANDACOLLO           ","PUERTO CORDILLERA","1","2",13,17,30
"2020",661,"1","ANDACOLLO           ","PUERTO CORDILLERA","1","2",11,16,27
"2021",661,"1","ANDACOLLO           ","PUERTO CORDILLERA","1","2",11,19,30
"2022",661,"1","ANDACOLLO           ","PUERTO CORDILLERA","1","2",11,16,27
"2023",661,"1","ANDACOLLO           ","PUERTO CORDILLERA","1","2",11,13,24
"2024",661,"1","ANDACOLLO           ","PUERTO CORDILLERA","1","2",16,11,27
"2017",662,"1","ANDACOLLO           ","PUERTO CORDILLERA","1","2",3,5,8
"2018",662,"1","ANDACOLLO           ","PUERTO CORDILLERA","1","2",2,5,7
"2019",662,"1","ANDACOLLO           ","PUERTO CORDILLERA","1","2",3,3,6
"2020",662,"1","ANDACOLLO           ","PUERTO CORDILLERA","1","2",6,6,12
"2021",662,"1","ANDACOLLO           ","PUERTO CORDILLERA","1","2",8,7,15
"2022",662,"1","ANDACOLLO           ","PUERTO CORDILLERA","1","2",8,5,13
"2023",662,"1","ANDACOLLO           ","PUERTO CORDILLERA","1","2",6,8,14
"2024",662,"1","ANDACOLLO           ","PUERTO CORDILLERA","1","2",5,10,15
"2017",783,"1","ANDACOLLO           ","PUERTO CORDILLERA","1","2",2,4,6
"2018",783,"1","ANDACOLLO           ","PUERTO CORDILLERA","1","2",2,5,7
"2019",783,"1","ANDACOLLO           ","PUERTO CORDILLERA","1","2",4,4,8
"2020",783,"1","ANDACOLLO           ","PUERTO CORDILLERA","1","2",3,5,8
"2021",783,"1","ANDACOLLO           ","PUERTO CORDILLERA","1","2",2,3,5
"2022",783,"1","ANDACOLLO           ","PUERTO CORDILLERA","1","2",2,4,6
"2023",783,"1","ANDACOLLO           ","PUERTO CORDILLERA","1","2",2,4,6
"2024",783,"1","ANDACOLLO           ","PUERTO CORDILLERA","1","2",1,4,5
"2017",795,"1","ANDACOLLO           ","PUERTO CORDILLERA","1","2",4,4,8
"2018",795,"1","ANDACOLLO           ","PUERTO CORDILLERA","1","2",4,4,8
"2019",795,"1","ANDACOLLO           ","PUERTO CORDILLERA","1","2",5,3,8
"2020",795,"1","ANDACOLLO           ","PUERTO CORDILLERA","1","2",2,3,5
"2021",795,"1","ANDACOLLO           ","PUERTO CORDILLERA","1","2",2,3,5
"2022",795,"1","ANDACOLLO           ","PUERTO CORDILLERA","1","2",2,4,6
"2023",795,"1","ANDACOLLO           ","PUERTO CORDILLERA","1","2",2,2,4
"2024",795,"1","ANDACOLLO           ","PUERTO CORDILLERA","1","2",2,1,3
"2017",4531,"0","CONCEPCIÓN         ","ANDALIÉN SUR","1","7",588,584,1172
"2018",4531,"0","CONCEPCIÓN         ","ANDALIÉN SUR","1","7",632,574,1206
"2019",4531,"0","CONCEPCIÓN         ","ANDALIÉN SUR","1","7",619,564,1183
"2020",4531,"0","CONCEPCIÓN         ","ANDALIÉN SUR","1","7",620,564,1184
"2021",4531,"0","CONCEPCIÓN         ","ANDALIÉN SUR","1","7",610,535,1145
"2022",4531,"0","CONCEPCIÓN         ","ANDALIÉN SUR","1","7",568,537,1105
"2023",4531,"0","CONCEPCIÓN         ","ANDALIÉN SUR","1","7",550,484,1034
"2024",4531,"0","CONCEPCIÓN         ","ANDALIÉN SUR","1","7",505,438,943
"2017",4540,"0","CONCEPCIÓN         ","ANDALIÉN SUR","1","7",65,76,141
"2018",4540,"0","CONCEPCIÓN         ","ANDALIÉN SUR","1","7",57,65,122
"2019",4540,"0","CONCEPCIÓN         ","ANDALIÉN SUR","1","7",53,67,120
"2020",4540,"0","CONCEPCIÓN         ","ANDALIÉN SUR","1","7",61,52,113
"2021",4540,"0","CONCEPCIÓN         ","ANDALIÉN SUR","1","7",50,40,90
"2022",4540,"0","CONCEPCIÓN         ","ANDALIÉN SUR","1","7",54,49,103
"2023",4540,"0","CONCEPCIÓN         ","ANDALIÉN SUR","1","7",46,51,97
"2024",4540,"0","CONCEPCIÓN         ","ANDALIÉN SUR","1","7",46,45,91
"2017",4543,"0","CONCEPCIÓN         ","ANDALIÉN SUR","1","7",61,46,107
"2018",4543,"0","CONCEPCIÓN         ","ANDALIÉN SUR","1","7",60,47,107
"2019",4543,"0","CONCEPCIÓN         ","ANDALIÉN SUR","1","7",65,48,113
"2020",4543,"0","CONCEPCIÓN         ","ANDALIÉN SUR","1","7",58,42,100
"2021",4543,"0","CONCEPCIÓN         ","ANDALIÉN SUR","1","7",51,38,89
"2022",4543,"0","CONCEPCIÓN         ","ANDALIÉN SUR","1","7",60,35,95
"2023",4543,"0","CONCEPCIÓN         ","ANDALIÉN SUR","1","7",51,35,86
"2024",4543,"0","CONCEPCIÓN         ","ANDALIÉN SUR","1","7",60,35,95
"2017",4546,"0","CONCEPCIÓN         ","ANDALIÉN SUR","1","7",73,47,120
"2018",4546,"0","CONCEPCIÓN         ","ANDALIÉN SUR","1","7",60,43,103
"2019",4546,"0","CONCEPCIÓN         ","ANDALIÉN SUR","1","7",68,46,114
"2020",4546,"0","CONCEPCIÓN         ","ANDALIÉN SUR","1","7",67,46,113
"2021",4546,"0","CONCEPCIÓN         ","ANDALIÉN SUR","1","7",53,43,96
"2022",4546,"0","CONCEPCIÓN         ","ANDALIÉN SUR","1","7",51,39,90
"2023",4546,"0","CONCEPCIÓN         ","ANDALIÉN SUR","1","7",62,42,104
"2024",4546,"0","CONCEPCIÓN         ","ANDALIÉN SUR","1","7",63,39,102
"2017",4548,"0","CONCEPCIÓN         ","ANDALIÉN SUR","1","7",133,101,234
"2018",4548,"0","CONCEPCIÓN         ","ANDALIÉN SUR","1","7",141,93,234
"2019",4548,"0","CONCEPCIÓN         ","ANDALIÉN SUR","1","7",156,103,259
"2020",4548,"0","CONCEPCIÓN         ","ANDALIÉN SUR","1","7",167,91,258
"2021",4548,"0","CONCEPCIÓN         ","ANDALIÉN SUR","1","7",173,87,260
"2022",4548,"0","CONCEPCIÓN         ","ANDALIÉN SUR","1","7",150,113,263
"2023",4548,"0","CONCEPCIÓN         ","ANDALIÉN SUR","1","7",150,102,252
"2024",4548,"0","CONCEPCIÓN         ","ANDALIÉN SUR","1","7",143,108,251
"2017",4551,"0","CONCEPCIÓN         ","ANDALIÉN SUR","1","7",16,14,30
"2018",4551,"0","CONCEPCIÓN         ","ANDALIÉN SUR","1","7",14,10,24
"2019",4551,"0","CONCEPCIÓN         ","ANDALIÉN SUR","1","7",14,12,26
"2020",4551,"0","CONCEPCIÓN         ","ANDALIÉN SUR","1","7",11,9,20
"2021",4551,"0","CONCEPCIÓN         ","ANDALIÉN SUR","1","7",4,4,8
"2022",4551,"0","CONCEPCIÓN         ","ANDALIÉN SUR","1","7",11,8,19
"2023",4551,"0","CONCEPCIÓN         ","ANDALIÉN SUR","1","7",11,12,23
"2024",4551,"0","CONCEPCIÓN         ","ANDALIÉN SUR","1","7",17,10,27
"2017",4553,"0","CONCEPCIÓN         ","ANDALIÉN SUR","1","7",0,884,884
"2018",4553,"0","CONCEPCIÓN         ","ANDALIÉN SUR","1","7",1,801,802
"2019",4553,"0","CONCEPCIÓN         ","ANDALIÉN SUR","1","7",2,657,659
"2020",4553,"0","CONCEPCIÓN         ","ANDALIÉN SUR","1","7",0,532,532
"2021",4553,"0","CONCEPCIÓN         ","ANDALIÉN SUR","1","7",3,442,445
"2022",4553,"0","CONCEPCIÓN         ","ANDALIÉN SUR","1","7",2,389,391
"2023",4553,"0","CONCEPCIÓN         ","ANDALIÉN SUR","1","7",4,370,374
"2024",4553,"0","CONCEPCIÓN         ","ANDALIÉN SUR","1","7",3,365,368
"2017",4555,"0","CONCEPCIÓN         ","ANDALIÉN SUR","1","7",452,0,452
"2018",4555,"0","CONCEPCIÓN         ","ANDALIÉN SUR","1","7",394,0,394
"2019",4555,"0","CONCEPCIÓN         ","ANDALIÉN SUR","1","7",359,0,359
"2020",4555,"0","CONCEPCIÓN         ","ANDALIÉN SUR","1","7",299,0,299
"2021",4555,"0","CONCEPCIÓN         ","ANDALIÉN SUR","1","7",271,0,271
"2022",4555,"0","CONCEPCIÓN         ","ANDALIÉN SUR","1","7",325,0,325
"2023",4555,"0","CONCEPCIÓN         ","ANDALIÉN SUR","1","7",317,0,317
"2024",4555,"0","CONCEPCIÓN         ","ANDALIÉN SUR","1","7",348,0,348
"2017",4557,"0","CONCEPCIÓN         ","ANDALIÉN SUR","1","7",133,104,237
"2018",4557,"0","CONCEPCIÓN         ","ANDALIÉN SUR","1","7",120,74,194
"2019",4557,"0","CONCEPCIÓN         ","ANDALIÉN SUR","1","7",105,64,169
"2020",4557,"0","CONCEPCIÓN         ","ANDALIÉN SUR","1","7",94,83,177
"2021",4557,"0","CONCEPCIÓN         ","ANDALIÉN SUR","1","7",104,100,204
"2022",4557,"0","CONCEPCIÓN         ","ANDALIÉN SUR","1","7",131,108,239
"2023",4557,"0","CONCEPCIÓN         ","ANDALIÉN SUR","1","7",157,148,305
"2024",4557,"0","CONCEPCIÓN         ","ANDALIÉN SUR","1","7",163,171,334
"2017",4558,"0","CONCEPCIÓN         ","ANDALIÉN SUR","1","7",119,134,253
"2018",4558,"0","CONCEPCIÓN         ","ANDALIÉN SUR","1","7",68,83,151
"2019",4558,"0","CONCEPCIÓN         ","ANDALIÉN SUR","1","7",81,97,178
"2020",4558,"0","CONCEPCIÓN         ","ANDALIÉN SUR","1","7",69,63,132
"2021",4558,"0","CONCEPCIÓN         ","ANDALIÉN SUR","1","7",101,107,208
"2022",4558,"0","CONCEPCIÓN         ","ANDALIÉN SUR","1","7",96,93,189
"2023",4558,"0","CONCEPCIÓN         ","ANDALIÉN SUR","1","7",78,52,130
"2024",4558,"0","CONCEPCIÓN         ","ANDALIÉN SUR","1","7",100,71,171
"2017",4559,"0","CONCEPCIÓN         ","ANDALIÉN SUR","1","7",31,30,61
"2018",4559,"0","CONCEPCIÓN         ","ANDALIÉN SUR","1","7",29,43,72
"2019",4559,"0","CONCEPCIÓN         ","ANDALIÉN SUR","1","7",30,25,55
"2020",4559,"0","CONCEPCIÓN         ","ANDALIÉN SUR","1","7",30,28,58
"2021",4559,"0","CONCEPCIÓN         ","ANDALIÉN SUR","1","7",22,26,48
"2022",4559,"0","CONCEPCIÓN         ","ANDALIÉN SUR","1","7",27,23,50
"2023",4559,"0","CONCEPCIÓN         ","ANDALIÉN SUR","1","7",41,17,58
"2024",4559,"0","CONCEPCIÓN         ","ANDALIÉN SUR","1","7",61,32,93
"2017",4560,"0","CHIGUAYANTE         ","ANDALIÉN SUR","1","7",108,86,194
"2018",4560,"0","CHIGUAYANTE         ","ANDALIÉN SUR","1","7",114,103,217
"2019",4560,"0","CHIGUAYANTE         ","ANDALIÉN SUR","1","7",203,150,353
"2020",4560,"0","CHIGUAYANTE         ","ANDALIÉN SUR","1","7",209,151,360
"2021",4560,"0","CHIGUAYANTE         ","ANDALIÉN SUR","1","7",192,141,333
"2022",4560,"0","CHIGUAYANTE         ","ANDALIÉN SUR","1","7",185,126,311
"2023",4560,"0","CHIGUAYANTE         ","ANDALIÉN SUR","1","7",160,102,262
"2024",4560,"0","CHIGUAYANTE         ","ANDALIÉN SUR","1","7",138,116,254
"2017",4561,"0","CONCEPCIÓN         ","ANDALIÉN SUR","1","7",47,31,78
"2018",4561,"0","CONCEPCIÓN         ","ANDALIÉN SUR","1","7",54,26,80
"2019",4561,"0","CONCEPCIÓN         ","ANDALIÉN SUR","1","7",45,32,77
"2020",4561,"0","CONCEPCIÓN         ","ANDALIÉN SUR","1","7",35,34,69
"2021",4561,"0","CONCEPCIÓN         ","ANDALIÉN SUR","1","7",39,35,74
"2022",4561,"0","CONCEPCIÓN         ","ANDALIÉN SUR","1","7",75,57,132
"2023",4561,"0","CONCEPCIÓN         ","ANDALIÉN SUR","1","7",93,61,154
"2024",4561,"0","CONCEPCIÓN         ","ANDALIÉN SUR","1","7",94,78,172
"2017",4563,"0","CONCEPCIÓN         ","ANDALIÉN SUR","1","7",83,80,163
"2018",4563,"0","CONCEPCIÓN         ","ANDALIÉN SUR","1","7",92,72,164
"2019",4563,"0","CONCEPCIÓN         ","ANDALIÉN SUR","1","7",108,80,188
"2020",4563,"0","CONCEPCIÓN         ","ANDALIÉN SUR","1","7",116,91,207
"2021",4563,"0","CONCEPCIÓN         ","ANDALIÉN SUR","1","7",119,112,231
"2022",4563,"0","CONCEPCIÓN         ","ANDALIÉN SUR","1","7",144,120,264
"2023",4563,"0","CONCEPCIÓN         ","ANDALIÉN SUR","1","7",143,123,266
"2024",4563,"0","CONCEPCIÓN         ","ANDALIÉN SUR","1","7",136,126,262
"2017",4564,"0","CONCEPCIÓN         ","ANDALIÉN SUR","1","7",870,730,1600
"2018",4564,"0","CONCEPCIÓN         ","ANDALIÉN SUR","1","7",869,723,1592
"2019",4564,"0","CONCEPCIÓN         ","ANDALIÉN SUR","1","7",883,731,1614
"2020",4564,"0","CONCEPCIÓN         ","ANDALIÉN SUR","1","7",841,715,1556
"2021",4564,"0","CONCEPCIÓN         ","ANDALIÉN SUR","1","7",789,666,1455
"2022",4564,"0","CONCEPCIÓN         ","ANDALIÉN SUR","1","7",806,676,1482
"2023",4564,"0","CONCEPCIÓN         ","ANDALIÉN SUR","1","7",775,611,1386
"2024",4564,"0","CONCEPCIÓN         ","ANDALIÉN SUR","1","7",747,600,1347
"2017",4565,"0","CONCEPCIÓN         ","ANDALIÉN SUR","1","7",258,165,423
"2018",4565,"0","CONCEPCIÓN         ","ANDALIÉN SUR","1","7",274,168,442
"2019",4565,"0","CONCEPCIÓN         ","ANDALIÉN SUR","1","7",292,175,467
"2020",4565,"0","CONCEPCIÓN         ","ANDALIÉN SUR","1","7",276,189,465
"2021",4565,"0","CONCEPCIÓN         ","ANDALIÉN SUR","1","7",262,173,435
"2022",4565,"0","CONCEPCIÓN         ","ANDALIÉN SUR","1","7",274,203,477
"2023",4565,"0","CONCEPCIÓN         ","ANDALIÉN SUR","1","7",256,212,468
"2024",4565,"0","CONCEPCIÓN         ","ANDALIÉN SUR","1","7",228,199,427
"2017",4569,"0","CONCEPCIÓN         ","ANDALIÉN SUR","1","7",144,128,272
"2018",4569,"0","CONCEPCIÓN         ","ANDALIÉN SUR","1","7",144,134,278
"2019",4569,"0","CONCEPCIÓN         ","ANDALIÉN SUR","1","7",150,140,290
"2020",4569,"0","CONCEPCIÓN         ","ANDALIÉN SUR","1","7",137,140,277
"2021",4569,"0","CONCEPCIÓN         ","ANDALIÉN SUR","1","7",147,128,275
"2022",4569,"0","CONCEPCIÓN         ","ANDALIÉN SUR","1","7",128,123,251
"2023",4569,"0","CONCEPCIÓN         ","ANDALIÉN SUR","1","7",140,113,253
"2024",4569,"0","CONCEPCIÓN         ","ANDALIÉN SUR","1","7",128,111,239
"2017",4571,"0","CHIGUAYANTE         ","ANDALIÉN SUR","1","7",262,245,507
"2018",4571,"0","CHIGUAYANTE         ","ANDALIÉN SUR","1","7",219,196,415
"2019",4571,"0","CHIGUAYANTE         ","ANDALIÉN SUR","1","7",174,166,340
"2020",4571,"0","CHIGUAYANTE         ","ANDALIÉN SUR","1","7",145,147,292
"2021",4571,"0","CHIGUAYANTE         ","ANDALIÉN SUR","1","7",143,127,270
"2022",4571,"0","CHIGUAYANTE         ","ANDALIÉN SUR","1","7",135,116,251
"2023",4571,"0","CHIGUAYANTE         ","ANDALIÉN SUR","1","7",149,112,261
"2024",4571,"0","CHIGUAYANTE         ","ANDALIÉN SUR","1","7",134,91,225
"2017",4572,"0","CONCEPCIÓN         ","ANDALIÉN SUR","1","7",276,179,455
"2018",4572,"0","CONCEPCIÓN         ","ANDALIÉN SUR","1","7",250,158,408
"2019",4572,"0","CONCEPCIÓN         ","ANDALIÉN SUR","1","7",266,165,431
"2020",4572,"0","CONCEPCIÓN         ","ANDALIÉN SUR","1","7",236,154,390
"2021",4572,"0","CONCEPCIÓN         ","ANDALIÉN SUR","1","7",246,171,417
"2022",4572,"0","CONCEPCIÓN         ","ANDALIÉN SUR","1","7",225,175,400
"2023",4572,"0","CONCEPCIÓN         ","ANDALIÉN SUR","1","7",307,211,518
"2024",4572,"0","CONCEPCIÓN         ","ANDALIÉN SUR","1","7",314,207,521
"2017",4574,"0","CONCEPCIÓN         ","ANDALIÉN SUR","1","7",0,842,842
"2018",4574,"0","CONCEPCIÓN         ","ANDALIÉN SUR","1","7",0,891,891
"2019",4574,"0","CONCEPCIÓN         ","ANDALIÉN SUR","1","7",9,906,915
"2020",4574,"0","CONCEPCIÓN         ","ANDALIÉN SUR","1","7",9,875,884
"2021",4574,"0","CONCEPCIÓN         ","ANDALIÉN SUR","1","7",17,801,818
"2022",4574,"0","CONCEPCIÓN         ","ANDALIÉN SUR","1","7",16,741,757
"2023",4574,"0","CONCEPCIÓN         ","ANDALIÉN SUR","1","7",24,740,764
"2024",4574,"0","CONCEPCIÓN         ","ANDALIÉN SUR","1","7",17,740,757
"2017",4575,"0","CHIGUAYANTE         ","ANDALIÉN SUR","1","7",263,170,433
"2018",4575,"0","CHIGUAYANTE         ","ANDALIÉN SUR","1","7",290,202,492
"2019",4575,"0","CHIGUAYANTE         ","ANDALIÉN SUR","1","7",317,231,548
"2020",4575,"0","CHIGUAYANTE         ","ANDALIÉN SUR","1","7",290,224,514
"2021",4575,"0","CHIGUAYANTE         ","ANDALIÉN SUR","1","7",267,217,484
"2022",4575,"0","CHIGUAYANTE         ","ANDALIÉN SUR","1","7",256,193,449
"2023",4575,"0","CHIGUAYANTE         ","ANDALIÉN SUR","1","7",255,203,458
"2024",4575,"0","CHIGUAYANTE         ","ANDALIÉN SUR","1","7",254,202,456
"2017",4576,"0","CHIGUAYANTE         ","ANDALIÉN SUR","1","7",100,83,183
"2018",4576,"0","CHIGUAYANTE         ","ANDALIÉN SUR","1","7",115,88,203
"2019",4576,"0","CHIGUAYANTE         ","ANDALIÉN SUR","1","7",125,102,227
"2020",4576,"0","CHIGUAYANTE         ","ANDALIÉN SUR","1","7",138,93,231
"2021",4576,"0","CHIGUAYANTE         ","ANDALIÉN SUR","1","7",140,101,241
"2022",4576,"0","CHIGUAYANTE         ","ANDALIÉN SUR","1","7",143,93,236
"2023",4576,"0","CHIGUAYANTE         ","ANDALIÉN SUR","1","7",132,94,226
"2024",4576,"0","CHIGUAYANTE         ","ANDALIÉN SUR","1","7",112,82,194
"2017",4577,"0","CONCEPCIÓN         ","ANDALIÉN SUR","1","7",90,75,165
"2018",4577,"0","CONCEPCIÓN         ","ANDALIÉN SUR","1","7",106,97,203
"2019",4577,"0","CONCEPCIÓN         ","ANDALIÉN SUR","1","7",177,170,347
"2020",4577,"0","CONCEPCIÓN         ","ANDALIÉN SUR","1","7",179,164,343
"2021",4577,"0","CONCEPCIÓN         ","ANDALIÉN SUR","1","7",190,166,356
"2022",4577,"0","CONCEPCIÓN         ","ANDALIÉN SUR","1","7",217,188,405
"2023",4577,"0","CONCEPCIÓN         ","ANDALIÉN SUR","1","7",198,168,366
"2024",4577,"0","CONCEPCIÓN         ","ANDALIÉN SUR","1","7",169,131,300
"2017",4579,"0","CONCEPCIÓN         ","ANDALIÉN SUR","1","7",183,157,340
"2018",4579,"0","CONCEPCIÓN         ","ANDALIÉN SUR","1","7",178,156,334
"2019",4579,"0","CONCEPCIÓN         ","ANDALIÉN SUR","1","7",163,163,326
"2020",4579,"0","CONCEPCIÓN         ","ANDALIÉN SUR","1","7",166,154,320
"2021",4579,"0","CONCEPCIÓN         ","ANDALIÉN SUR","1","7",156,142,298
"2022",4579,"0","CONCEPCIÓN         ","ANDALIÉN SUR","1","7",136,118,254
"2023",4579,"0","CONCEPCIÓN         ","ANDALIÉN SUR","1","7",116,124,240
"2024",4579,"0","CONCEPCIÓN         ","ANDALIÉN SUR","1","7",114,112,226
"2017",4581,"0","CONCEPCIÓN         ","ANDALIÉN SUR","1","7",61,49,110
"2018",4581,"0","CONCEPCIÓN         ","ANDALIÉN SUR","1","7",89,52,141
"2019",4581,"0","CONCEPCIÓN         ","ANDALIÉN SUR","1","7",78,56,134
"2020",4581,"0","CONCEPCIÓN         ","ANDALIÉN SUR","1","7",78,57,135
"2021",4581,"0","CONCEPCIÓN         ","ANDALIÉN SUR","1","7",89,60,149
"2022",4581,"0","CONCEPCIÓN         ","ANDALIÉN SUR","1","7",83,68,151
"2023",4581,"0","CONCEPCIÓN         ","ANDALIÉN SUR","1","7",69,59,128
"2024",4581,"0","CONCEPCIÓN         ","ANDALIÉN SUR","1","7",46,49,95
"2017",4582,"0","CONCEPCIÓN         ","ANDALIÉN SUR","1","7",51,37,88
"2018",4582,"0","CONCEPCIÓN         ","ANDALIÉN SUR","1","7",56,42,98
"2019",4582,"0","CONCEPCIÓN         ","ANDALIÉN SUR","1","7",62,44,106
"2020",4582,"0","CONCEPCIÓN         ","ANDALIÉN SUR","1","7",58,49,107
"2021",4582,"0","CONCEPCIÓN         ","ANDALIÉN SUR","1","7",65,40,105
"2022",4582,"0","CONCEPCIÓN         ","ANDALIÉN SUR","1","7",81,54,135
"2023",4582,"0","CONCEPCIÓN         ","ANDALIÉN SUR","1","7",76,53,129
"2024",4582,"0","CONCEPCIÓN         ","ANDALIÉN SUR","1","7",79,56,135
"2017",4585,"0","CONCEPCIÓN         ","ANDALIÉN SUR","1","7",150,146,296
"2018",4585,"0","CONCEPCIÓN         ","ANDALIÉN SUR","1","7",180,145,325
"2019",4585,"0","CONCEPCIÓN         ","ANDALIÉN SUR","1","7",208,156,364
"2020",4585,"0","CONCEPCIÓN         ","ANDALIÉN SUR","1","7",223,171,394
"2021",4585,"0","CONCEPCIÓN         ","ANDALIÉN SUR","1","7",224,178,402
"2022",4585,"0","CONCEPCIÓN         ","ANDALIÉN SUR","1","7",225,184,409
"2023",4585,"0","CONCEPCIÓN         ","ANDALIÉN SUR","1","7",222,183,405
"2024",4585,"0","CONCEPCIÓN         ","ANDALIÉN SUR","1","7",217,191,408
"2017",4586,"0","CHIGUAYANTE         ","ANDALIÉN SUR","1","7",130,125,255
"2018",4586,"0","CHIGUAYANTE         ","ANDALIÉN SUR","1","7",121,108,229
"2019",4586,"0","CHIGUAYANTE         ","ANDALIÉN SUR","1","7",117,91,208
"2020",4586,"0","CHIGUAYANTE         ","ANDALIÉN SUR","1","7",100,75,175
"2021",4586,"0","CHIGUAYANTE         ","ANDALIÉN SUR","1","7",88,71,159
"2022",4586,"0","CHIGUAYANTE         ","ANDALIÉN SUR","1","7",67,73,140
"2023",4586,"0","CHIGUAYANTE         ","ANDALIÉN SUR","1","7",74,68,142
"2024",4586,"0","CHIGUAYANTE         ","ANDALIÉN SUR","1","7",57,51,108
"2017",4588,"0","CONCEPCIÓN         ","ANDALIÉN SUR","1","7",551,461,1012
"2018",4588,"0","CONCEPCIÓN         ","ANDALIÉN SUR","1","7",552,464,1016
"2019",4588,"0","CONCEPCIÓN         ","ANDALIÉN SUR","1","7",542,462,1004
"2020",4588,"0","CONCEPCIÓN         ","ANDALIÉN SUR","1","7",491,417,908
"2021",4588,"0","CONCEPCIÓN         ","ANDALIÉN SUR","1","7",484,411,895
"2022",4588,"0","CONCEPCIÓN         ","ANDALIÉN SUR","1","7",488,447,935
"2023",4588,"0","CONCEPCIÓN         ","ANDALIÉN SUR","1","7",450,395,845
"2024",4588,"0","CONCEPCIÓN         ","ANDALIÉN SUR","1","7",422,379,801
"2017",4589,"0","CONCEPCIÓN         ","ANDALIÉN SUR","1","7",153,128,281
"2018",4589,"0","CONCEPCIÓN         ","ANDALIÉN SUR","1","7",143,122,265
"2019",4589,"0","CONCEPCIÓN         ","ANDALIÉN SUR","1","7",128,130,258
"2020",4589,"0","CONCEPCIÓN         ","ANDALIÉN SUR","1","7",131,113,244
"2021",4589,"0","CONCEPCIÓN         ","ANDALIÉN SUR","1","7",125,118,243
"2022",4589,"0","CONCEPCIÓN         ","ANDALIÉN SUR","1","7",130,114,244
"2023",4589,"0","CONCEPCIÓN         ","ANDALIÉN SUR","1","7",139,113,252
"2024",4589,"0","CONCEPCIÓN         ","ANDALIÉN SUR","1","7",126,104,230
"2017",4591,"0","CHIGUAYANTE         ","ANDALIÉN SUR","1","7",244,251,495
"2018",4591,"0","CHIGUAYANTE         ","ANDALIÉN SUR","1","7",283,267,550
"2019",4591,"0","CHIGUAYANTE         ","ANDALIÉN SUR","1","7",275,264,539
"2020",4591,"0","CHIGUAYANTE         ","ANDALIÉN SUR","1","7",244,237,481
"2021",4591,"0","CHIGUAYANTE         ","ANDALIÉN SUR","1","7",238,234,472
"2022",4591,"0","CHIGUAYANTE         ","ANDALIÉN SUR","1","7",228,222,450
"2023",4591,"0","CHIGUAYANTE         ","ANDALIÉN SUR","1","7",228,210,438
"2024",4591,"0","CHIGUAYANTE         ","ANDALIÉN SUR","1","7",204,186,390
"2017",4592,"0","CONCEPCIÓN         ","ANDALIÉN SUR","1","7",114,79,193
"2018",4592,"0","CONCEPCIÓN         ","ANDALIÉN SUR","1","7",134,85,219
"2019",4592,"0","CONCEPCIÓN         ","ANDALIÉN SUR","1","7",114,78,192
"2020",4592,"0","CONCEPCIÓN         ","ANDALIÉN SUR","1","7",118,78,196
"2021",4592,"0","CONCEPCIÓN         ","ANDALIÉN SUR","1","7",109,78,187
"2022",4592,"0","CONCEPCIÓN         ","ANDALIÉN SUR","1","7",118,86,204
"2023",4592,"0","CONCEPCIÓN         ","ANDALIÉN SUR","1","7",105,85,190
"2024",4592,"0","CONCEPCIÓN         ","ANDALIÉN SUR","1","7",90,74,164
"2017",4597,"0","CHIGUAYANTE         ","ANDALIÉN SUR","1","7",54,42,96
"2018",4597,"0","CHIGUAYANTE         ","ANDALIÉN SUR","1","7",30,27,57
"2019",4597,"0","CHIGUAYANTE         ","ANDALIÉN SUR","1","7",20,24,44
"2020",4597,"0","CHIGUAYANTE         ","ANDALIÉN SUR","1","7",16,27,43
"2021",4597,"0","CHIGUAYANTE         ","ANDALIÉN SUR","1","7",11,24,35
"2022",4597,"0","CHIGUAYANTE         ","ANDALIÉN SUR","1","7",18,15,33
"2023",4597,"0","CHIGUAYANTE         ","ANDALIÉN SUR","1","7",18,19,37
"2024",4597,"0","CHIGUAYANTE         ","ANDALIÉN SUR","1","7",22,25,47
"2017",4603,"0","CONCEPCIÓN         ","ANDALIÉN SUR","1","7",68,40,108
"2018",4603,"0","CONCEPCIÓN         ","ANDALIÉN SUR","1","7",64,43,107
"2019",4603,"0","CONCEPCIÓN         ","ANDALIÉN SUR","1","7",76,49,125
"2020",4603,"0","CONCEPCIÓN         ","ANDALIÉN SUR","1","7",71,41,112
"2021",4603,"0","CONCEPCIÓN         ","ANDALIÉN SUR","1","7",69,48,117
"2022",4603,"0","CONCEPCIÓN         ","ANDALIÉN SUR","1","7",79,55,134
"2023",4603,"0","CONCEPCIÓN         ","ANDALIÉN SUR","1","7",83,49,132
"2024",4603,"0","CONCEPCIÓN         ","ANDALIÉN SUR","1","7",67,47,114
"2017",4609,"0","CONCEPCIÓN         ","ANDALIÉN SUR","1","7",103,90,193
"2018",4609,"0","CONCEPCIÓN         ","ANDALIÉN SUR","1","7",90,76,166
"2019",4609,"0","CONCEPCIÓN         ","ANDALIÉN SUR","1","7",95,62,157
"2020",4609,"0","CONCEPCIÓN         ","ANDALIÉN SUR","1","7",81,64,145
"2021",4609,"0","CONCEPCIÓN         ","ANDALIÉN SUR","1","7",88,56,144
"2022",4609,"0","CONCEPCIÓN         ","ANDALIÉN SUR","1","7",100,70,170
"2023",4609,"0","CONCEPCIÓN         ","ANDALIÉN SUR","1","7",93,58,151
"2024",4609,"0","CONCEPCIÓN         ","ANDALIÉN SUR","1","7",83,49,132
"2017",4612,"0","CONCEPCIÓN         ","ANDALIÉN SUR","1","7",58,35,93
"2018",4612,"0","CONCEPCIÓN         ","ANDALIÉN SUR","1","7",60,32,92
"2019",4612,"0","CONCEPCIÓN         ","ANDALIÉN SUR","1","7",44,29,73
"2020",4612,"0","CONCEPCIÓN         ","ANDALIÉN SUR","1","7",54,32,86
"2021",4612,"0","CONCEPCIÓN         ","ANDALIÉN SUR","1","7",54,39,93
"2022",4612,"0","CONCEPCIÓN         ","ANDALIÉN SUR","1","7",52,42,94
"2023",4612,"0","CONCEPCIÓN         ","ANDALIÉN SUR","1","7",48,43,91
"2024",4612,"0","CONCEPCIÓN         ","ANDALIÉN SUR","1","7",39,39,78
"2017",4613,"0","CONCEPCIÓN         ","ANDALIÉN SUR","1","7",60,30,90
"2018",4613,"0","CONCEPCIÓN         ","ANDALIÉN SUR","1","7",47,30,77
"2019",4613,"0","CONCEPCIÓN         ","ANDALIÉN SUR","1","7",50,26,76
"2020",4613,"0","CONCEPCIÓN         ","ANDALIÉN SUR","1","7",50,36,86
"2021",4613,"0","CONCEPCIÓN         ","ANDALIÉN SUR","1","7",51,33,84
"2022",4613,"0","CONCEPCIÓN         ","ANDALIÉN SUR","1","7",47,23,70
"2023",4613,"0","CONCEPCIÓN         ","ANDALIÉN SUR","1","7",47,23,70
"2024",4613,"0","CONCEPCIÓN         ","ANDALIÉN SUR","1","7",52,26,78
"2017",4614,"1","CONCEPCIÓN         ","ANDALIÉN SUR","1","7",103,94,197
"2018",4614,"1","CONCEPCIÓN         ","ANDALIÉN SUR","1","7",103,103,206
"2019",4614,"1","CONCEPCIÓN         ","ANDALIÉN SUR","1","7",104,89,193
"2020",4614,"1","CONCEPCIÓN         ","ANDALIÉN SUR","1","7",94,95,189
"2021",4614,"1","CONCEPCIÓN         ","ANDALIÉN SUR","1","7",89,94,183
"2022",4614,"1","CONCEPCIÓN         ","ANDALIÉN SUR","1","7",90,91,181
"2023",4614,"1","CONCEPCIÓN         ","ANDALIÉN SUR","1","7",91,101,192
"2024",4614,"1","CONCEPCIÓN         ","ANDALIÉN SUR","1","7",95,94,189
"2017",4622,"1","CONCEPCIÓN         ","ANDALIÉN SUR","1","7",47,44,91
"2018",4622,"1","CONCEPCIÓN         ","ANDALIÉN SUR","1","7",59,54,113
"2019",4622,"1","CONCEPCIÓN         ","ANDALIÉN SUR","1","7",67,62,129
"2020",4622,"1","CONCEPCIÓN         ","ANDALIÉN SUR","1","7",76,63,139
"2021",4622,"1","CONCEPCIÓN         ","ANDALIÉN SUR","1","7",71,61,132
"2022",4622,"1","CONCEPCIÓN         ","ANDALIÉN SUR","1","7",72,69,141
"2023",4622,"1","CONCEPCIÓN         ","ANDALIÉN SUR","1","7",77,67,144
"2024",4622,"1","CONCEPCIÓN         ","ANDALIÉN SUR","1","7",87,71,158
"2017",4869,"0","FLORIDA             ","ANDALIÉN SUR","1","7",197,185,382
"2018",4869,"0","FLORIDA             ","ANDALIÉN SUR","1","7",199,188,387
"2019",4869,"0","FLORIDA             ","ANDALIÉN SUR","1","7",200,186,386
"2020",4869,"0","FLORIDA             ","ANDALIÉN SUR","1","7",200,180,380
"2021",4869,"0","FLORIDA             ","ANDALIÉN SUR","1","7",206,181,387
"2022",4869,"0","FLORIDA             ","ANDALIÉN SUR","1","7",210,179,389
"2023",4869,"0","FLORIDA             ","ANDALIÉN SUR","1","7",205,177,382
"2024",4869,"0","FLORIDA             ","ANDALIÉN SUR","1","7",205,177,382
"2017",4870,"0","FLORIDA             ","ANDALIÉN SUR","1","7",101,113,214
"2018",4870,"0","FLORIDA             ","ANDALIÉN SUR","1","7",97,113,210
"2019",4870,"0","FLORIDA             ","ANDALIÉN SUR","1","7",101,109,210
"2020",4870,"0","FLORIDA             ","ANDALIÉN SUR","1","7",99,123,222
"2021",4870,"0","FLORIDA             ","ANDALIÉN SUR","1","7",105,113,218
"2022",4870,"0","FLORIDA             ","ANDALIÉN SUR","1","7",119,129,248
"2023",4870,"0","FLORIDA             ","ANDALIÉN SUR","1","7",135,135,270
"2024",4870,"0","FLORIDA             ","ANDALIÉN SUR","1","7",148,140,288
"2017",4871,"1","FLORIDA             ","ANDALIÉN SUR","1","7",103,104,207
"2018",4871,"1","FLORIDA             ","ANDALIÉN SUR","1","7",102,93,195
"2019",4871,"1","FLORIDA             ","ANDALIÉN SUR","1","7",99,98,197
"2020",4871,"1","FLORIDA             ","ANDALIÉN SUR","1","7",102,99,201
"2021",4871,"1","FLORIDA             ","ANDALIÉN SUR","1","7",108,102,210
"2022",4871,"1","FLORIDA             ","ANDALIÉN SUR","1","7",118,124,242
"2023",4871,"1","FLORIDA             ","ANDALIÉN SUR","1","7",112,146,258
"2024",4871,"1","FLORIDA             ","ANDALIÉN SUR","1","7",121,151,272
"2017",4873,"1","FLORIDA             ","ANDALIÉN SUR","1","7",70,85,155
"2018",4873,"1","FLORIDA             ","ANDALIÉN SUR","1","7",67,76,143
"2019",4873,"1","FLORIDA             ","ANDALIÉN SUR","1","7",69,70,139
"2020",4873,"1","FLORIDA             ","ANDALIÉN SUR","1","7",68,63,131
"2021",4873,"1","FLORIDA             ","ANDALIÉN SUR","1","7",76,66,142
"2022",4873,"1","FLORIDA             ","ANDALIÉN SUR","1","7",78,70,148
"2023",4873,"1","FLORIDA             ","ANDALIÉN SUR","1","7",78,71,149
"2024",4873,"1","FLORIDA             ","ANDALIÉN SUR","1","7",73,64,137
"2017",4875,"1","FLORIDA             ","ANDALIÉN SUR","1","7",4,5,9
"2018",4875,"1","FLORIDA             ","ANDALIÉN SUR","1","7",7,4,11
"2019",4875,"1","FLORIDA             ","ANDALIÉN SUR","1","7",8,4,12
"2020",4875,"1","FLORIDA             ","ANDALIÉN SUR","1","7",4,4,8
"2021",4875,"1","FLORIDA             ","ANDALIÉN SUR","1","7",3,5,8
"2022",4875,"1","FLORIDA             ","ANDALIÉN SUR","1","7",7,3,10
"2023",4875,"1","FLORIDA             ","ANDALIÉN SUR","1","7",3,1,4
"2024",4875,"1","FLORIDA             ","ANDALIÉN SUR","1","7",4,0,4
"2017",4877,"1","FLORIDA             ","ANDALIÉN SUR","1","7",1,3,4
"2018",4877,"1","FLORIDA             ","ANDALIÉN SUR","1","7",5,3,8
"2019",4877,"1","FLORIDA             ","ANDALIÉN SUR","1","7",5,2,7
"2020",4877,"1","FLORIDA             ","ANDALIÉN SUR","1","7",7,2,9
"2021",4877,"1","FLORIDA             ","ANDALIÉN SUR","1","7",9,3,12
"2022",4877,"1","FLORIDA             ","ANDALIÉN SUR","1","7",8,2,10
"2023",4877,"1","FLORIDA             ","ANDALIÉN SUR","1","7",7,4,11
"2024",4877,"1","FLORIDA             ","ANDALIÉN SUR","1","7",5,4,9
"2017",4879,"1","FLORIDA             ","ANDALIÉN SUR","1","7",16,7,23
"2018",4879,"1","FLORIDA             ","ANDALIÉN SUR","1","7",16,8,24
"2019",4879,"1","FLORIDA             ","ANDALIÉN SUR","1","7",19,15,34
"2020",4879,"1","FLORIDA             ","ANDALIÉN SUR","1","7",16,13,29
"2021",4879,"1","FLORIDA             ","ANDALIÉN SUR","1","7",15,19,34
"2022",4879,"1","FLORIDA             ","ANDALIÉN SUR","1","7",17,24,41
"2023",4879,"1","FLORIDA             ","ANDALIÉN SUR","1","7",16,25,41
"2024",4879,"1","FLORIDA             ","ANDALIÉN SUR","1","7",17,28,45
"2017",4882,"1","FLORIDA             ","ANDALIÉN SUR","1","7",8,9,17
"2018",4882,"1","FLORIDA             ","ANDALIÉN SUR","1","7",8,9,17
"2019",4882,"1","FLORIDA             ","ANDALIÉN SUR","1","7",5,6,11
"2020",4882,"1","FLORIDA             ","ANDALIÉN SUR","1","7",5,4,9
"2021",4882,"1","FLORIDA             ","ANDALIÉN SUR","1","7",9,5,14
"2022",4882,"1","FLORIDA             ","ANDALIÉN SUR","1","7",8,4,12
"2023",4882,"1","FLORIDA             ","ANDALIÉN SUR","1","7",4,3,7
"2024",4882,"1","FLORIDA             ","ANDALIÉN SUR","1","7",3,2,5
"2017",4886,"1","FLORIDA             ","ANDALIÉN SUR","1","7",6,3,9
"2018",4886,"1","FLORIDA             ","ANDALIÉN SUR","1","7",7,2,9
"2019",4886,"1","FLORIDA             ","ANDALIÉN SUR","1","7",6,3,9
"2020",4886,"1","FLORIDA             ","ANDALIÉN SUR","1","7",4,3,7
"2021",4886,"1","FLORIDA             ","ANDALIÉN SUR","1","7",4,4,8
"2022",4886,"1","FLORIDA             ","ANDALIÉN SUR","1","7",4,4,8
"2023",4886,"1","FLORIDA             ","ANDALIÉN SUR","1","7",6,3,9
"2024",4886,"1","FLORIDA             ","ANDALIÉN SUR","1","7",6,4,10
"2017",4889,"1","FLORIDA             ","ANDALIÉN SUR","1","7",4,4,8
"2018",4889,"1","FLORIDA             ","ANDALIÉN SUR","1","7",5,3,8
"2019",4889,"1","FLORIDA             ","ANDALIÉN SUR","1","7",5,3,8
"2020",4889,"1","FLORIDA             ","ANDALIÉN SUR","1","7",5,2,7
"2021",4889,"1","FLORIDA             ","ANDALIÉN SUR","1","7",6,2,8
"2022",4889,"1","FLORIDA             ","ANDALIÉN SUR","1","7",8,3,11
"2023",4889,"1","FLORIDA             ","ANDALIÉN SUR","1","7",7,4,11
"2024",4889,"1","FLORIDA             ","ANDALIÉN SUR","1","7",2,3,5
"2017",4890,"1","FLORIDA             ","ANDALIÉN SUR","1","7",34,33,67
"2018",4890,"1","FLORIDA             ","ANDALIÉN SUR","1","7",32,26,58
"2019",4890,"1","FLORIDA             ","ANDALIÉN SUR","1","7",41,32,73
"2020",4890,"1","FLORIDA             ","ANDALIÉN SUR","1","7",47,32,79
"2021",4890,"1","FLORIDA             ","ANDALIÉN SUR","1","7",53,45,98
"2022",4890,"1","FLORIDA             ","ANDALIÉN SUR","1","7",57,49,106
"2023",4890,"1","FLORIDA             ","ANDALIÉN SUR","1","7",52,42,94
"2024",4890,"1","FLORIDA             ","ANDALIÉN SUR","1","7",50,34,84
"2017",4897,"0","HUALQUI             ","ANDALIÉN SUR","1","7",353,332,685
"2018",4897,"0","HUALQUI             ","ANDALIÉN SUR","1","7",346,315,661
"2019",4897,"0","HUALQUI             ","ANDALIÉN SUR","1","7",353,298,651
"2020",4897,"0","HUALQUI             ","ANDALIÉN SUR","1","7",325,263,588
"2021",4897,"0","HUALQUI             ","ANDALIÉN SUR","1","7",324,283,607
"2022",4897,"0","HUALQUI             ","ANDALIÉN SUR","1","7",297,275,572
"2023",4897,"0","HUALQUI             ","ANDALIÉN SUR","1","7",279,248,527
"2024",4897,"0","HUALQUI             ","ANDALIÉN SUR","1","7",285,269,554
"2017",4898,"0","HUALQUI             ","ANDALIÉN SUR","1","7",315,308,623
"2018",4898,"0","HUALQUI             ","ANDALIÉN SUR","1","7",313,313,626
"2019",4898,"0","HUALQUI             ","ANDALIÉN SUR","1","7",311,326,637
"2020",4898,"0","HUALQUI             ","ANDALIÉN SUR","1","7",322,325,647
"2021",4898,"0","HUALQUI             ","ANDALIÉN SUR","1","7",313,317,630
"2022",4898,"0","HUALQUI             ","ANDALIÉN SUR","1","7",306,312,618
"2023",4898,"0","HUALQUI             ","ANDALIÉN SUR","1","7",307,313,620
"2024",4898,"0","HUALQUI             ","ANDALIÉN SUR","1","7",292,310,602
"2017",4901,"1","HUALQUI             ","ANDALIÉN SUR","1","7",3,1,4
"2018",4901,"1","HUALQUI             ","ANDALIÉN SUR","1","7",4,1,5
"2019",4901,"1","HUALQUI             ","ANDALIÉN SUR","1","7",3,0,3
"2020",4901,"1","HUALQUI             ","ANDALIÉN SUR","1","7",3,0,3
"2021",4901,"1","HUALQUI             ","ANDALIÉN SUR","1","7",3,1,4
"2022",4901,"1","HUALQUI             ","ANDALIÉN SUR","1","7",2,1,3
"2023",4901,"1","HUALQUI             ","ANDALIÉN SUR","1","7",2,1,3
"2024",4901,"1","HUALQUI             ","ANDALIÉN SUR","1","7",2,1,3
"2017",4902,"1","HUALQUI             ","ANDALIÉN SUR","1","7",130,74,204
"2018",4902,"1","HUALQUI             ","ANDALIÉN SUR","1","7",123,76,199
"2019",4902,"1","HUALQUI             ","ANDALIÉN SUR","1","7",118,74,192
"2020",4902,"1","HUALQUI             ","ANDALIÉN SUR","1","7",117,78,195
"2021",4902,"1","HUALQUI             ","ANDALIÉN SUR","1","7",121,74,195
"2022",4902,"1","HUALQUI             ","ANDALIÉN SUR","1","7",127,70,197
"2023",4902,"1","HUALQUI             ","ANDALIÉN SUR","1","7",128,86,214
"2024",4902,"1","HUALQUI             ","ANDALIÉN SUR","1","7",120,91,211
"2017",4904,"1","HUALQUI             ","ANDALIÉN SUR","1","7",7,2,9
"2018",4904,"1","HUALQUI             ","ANDALIÉN SUR","1","7",11,3,14
"2019",4904,"1","HUALQUI             ","ANDALIÉN SUR","1","7",11,3,14
"2020",4904,"1","HUALQUI             ","ANDALIÉN SUR","1","7",9,5,14
"2021",4904,"1","HUALQUI             ","ANDALIÉN SUR","1","7",7,2,9
"2022",4904,"1","HUALQUI             ","ANDALIÉN SUR","1","7",7,3,10
"2023",4904,"1","HUALQUI             ","ANDALIÉN SUR","1","7",6,3,9
"2024",4904,"1","HUALQUI             ","ANDALIÉN SUR","1","7",5,6,11
"2017",4906,"1","HUALQUI             ","ANDALIÉN SUR","1","7",3,8,11
"2018",4906,"1","HUALQUI             ","ANDALIÉN SUR","1","7",3,6,9
"2019",4906,"1","HUALQUI             ","ANDALIÉN SUR","1","7",2,5,7
"2020",4906,"1","HUALQUI             ","ANDALIÉN SUR","1","7",2,3,5
"2021",4906,"1","HUALQUI             ","ANDALIÉN SUR","1","7",3,3,6
"2022",4906,"1","HUALQUI             ","ANDALIÉN SUR","1","7",2,2,4
"2023",4906,"1","HUALQUI             ","ANDALIÉN SUR","1","7",1,0,1
"2024",4906,"1","HUALQUI             ","ANDALIÉN SUR","1","7",1,0,1
"2017",4907,"1","HUALQUI             ","ANDALIÉN SUR","1","7",1,1,2
"2018",4907,"1","HUALQUI             ","ANDALIÉN SUR","1","7",0,1,1
"2019",4907,"1","HUALQUI             ","ANDALIÉN SUR","1","7",0,1,1
"2020",4907,"1","HUALQUI             ","ANDALIÉN SUR","1","7",1,1,2
"2021",4907,"1","HUALQUI             ","ANDALIÉN SUR","1","7",2,1,3
"2022",4907,"1","HUALQUI             ","ANDALIÉN SUR","1","7",1,1,2
"2023",4907,"1","HUALQUI             ","ANDALIÉN SUR","1","7",1,0,1
"2024",4907,"1","HUALQUI             ","ANDALIÉN SUR","1","7",2,3,5
"2017",4908,"1","HUALQUI             ","ANDALIÉN SUR","1","7",55,30,85
"2018",4908,"1","HUALQUI             ","ANDALIÉN SUR","1","7",58,40,98
"2019",4908,"1","HUALQUI             ","ANDALIÉN SUR","1","7",53,42,95
"2020",4908,"1","HUALQUI             ","ANDALIÉN SUR","1","7",57,42,99
"2021",4908,"1","HUALQUI             ","ANDALIÉN SUR","1","7",59,43,102
"2022",4908,"1","HUALQUI             ","ANDALIÉN SUR","1","7",60,39,99
"2023",4908,"1","HUALQUI             ","ANDALIÉN SUR","1","7",65,49,114
"2024",4908,"1","HUALQUI             ","ANDALIÉN SUR","1","7",71,46,117
"2017",4909,"1","HUALQUI             ","ANDALIÉN SUR","1","7",32,17,49
"2018",4909,"1","HUALQUI             ","ANDALIÉN SUR","1","7",29,14,43
"2019",4909,"1","HUALQUI             ","ANDALIÉN SUR","1","7",27,15,42
"2020",4909,"1","HUALQUI             ","ANDALIÉN SUR","1","7",29,20,49
"2021",4909,"1","HUALQUI             ","ANDALIÉN SUR","1","7",33,22,55
"2022",4909,"1","HUALQUI             ","ANDALIÉN SUR","1","7",34,19,53
"2023",4909,"1","HUALQUI             ","ANDALIÉN SUR","1","7",36,20,56
"2024",4909,"1","HUALQUI             ","ANDALIÉN SUR","1","7",31,26,57
"2017",4913,"1","HUALQUI             ","ANDALIÉN SUR","1","7",2,5,7
"2018",4913,"1","HUALQUI             ","ANDALIÉN SUR","1","7",3,6,9
"2019",4913,"1","HUALQUI             ","ANDALIÉN SUR","1","7",0,5,5
"2020",4913,"1","HUALQUI             ","ANDALIÉN SUR","1","7",1,3,4
"2021",4913,"1","HUALQUI             ","ANDALIÉN SUR","1","7",2,3,5
"2022",4913,"1","HUALQUI             ","ANDALIÉN SUR","1","7",2,2,4
"2023",4913,"1","HUALQUI             ","ANDALIÉN SUR","1","7",2,1,3
"2024",4913,"1","HUALQUI             ","ANDALIÉN SUR","1","7",1,4,5
"2017",4915,"1","HUALQUI             ","ANDALIÉN SUR","1","7",17,2,19
"2018",4915,"1","HUALQUI             ","ANDALIÉN SUR","1","7",17,3,20
"2019",4915,"1","HUALQUI             ","ANDALIÉN SUR","1","7",19,5,24
"2020",4915,"1","HUALQUI             ","ANDALIÉN SUR","1","7",21,4,25
"2021",4915,"1","HUALQUI             ","ANDALIÉN SUR","1","7",17,3,20
"2022",4915,"1","HUALQUI             ","ANDALIÉN SUR","1","7",17,9,26
"2023",4915,"1","HUALQUI             ","ANDALIÉN SUR","1","7",17,8,25
"2024",4915,"1","HUALQUI             ","ANDALIÉN SUR","1","7",15,4,19
"2017",4917,"1","HUALQUI             ","ANDALIÉN SUR","1","7",1,3,4
"2018",4917,"1","HUALQUI             ","ANDALIÉN SUR","1","7",1,4,5
"2019",4917,"1","HUALQUI             ","ANDALIÉN SUR","1","7",1,2,3
"2020",4917,"1","HUALQUI             ","ANDALIÉN SUR","1","7",1,3,4
"2021",4917,"1","HUALQUI             ","ANDALIÉN SUR","1","7",1,3,4
"2022",4917,"1","HUALQUI             ","ANDALIÉN SUR","1","7",1,3,4
"2023",4917,"1","HUALQUI             ","ANDALIÉN SUR","1","7",0,2,2
"2024",4917,"1","HUALQUI             ","ANDALIÉN SUR","1","7",0,2,2
"2017",4918,"1","HUALQUI             ","ANDALIÉN SUR","1","7",5,7,12
"2018",4918,"1","HUALQUI             ","ANDALIÉN SUR","1","7",7,7,14
"2019",4918,"1","HUALQUI             ","ANDALIÉN SUR","1","7",8,1,9
"2020",4918,"1","HUALQUI             ","ANDALIÉN SUR","1","7",4,0,4
"2021",4918,"1","HUALQUI             ","ANDALIÉN SUR","1","7",5,0,5
"2022",4918,"1","HUALQUI             ","ANDALIÉN SUR","1","7",12,2,14
"2023",4918,"1","HUALQUI             ","ANDALIÉN SUR","1","7",13,4,17
"2024",4918,"1","HUALQUI             ","ANDALIÉN SUR","1","7",7,2,9
"2017",4920,"1","HUALQUI             ","ANDALIÉN SUR","1","7",4,7,11
"2018",4920,"1","HUALQUI             ","ANDALIÉN SUR","1","7",4,5,9
"2019",4920,"1","HUALQUI             ","ANDALIÉN SUR","1","7",3,4,7
"2020",4920,"1","HUALQUI             ","ANDALIÉN SUR","1","7",2,3,5
"2021",4920,"1","HUALQUI             ","ANDALIÉN SUR","1","7",1,4,5
"2022",4920,"1","HUALQUI             ","ANDALIÉN SUR","1","7",2,4,6
"2023",4920,"1","HUALQUI             ","ANDALIÉN SUR","1","7",2,1,3
"2024",4920,"1","HUALQUI             ","ANDALIÉN SUR","1","7",2,1,3
"2017",6348,"0","TOLTÉN             ","COSTA ARAUCANÍA","1","4",196,178,374
"2018",6348,"0","TOLTÉN             ","COSTA ARAUCANÍA","1","4",209,188,397
"2019",6348,"0","TOLTÉN             ","COSTA ARAUCANÍA","1","4",205,204,409
"2020",6348,"0","TOLTÉN             ","COSTA ARAUCANÍA","1","4",183,172,355
"2021",6348,"0","TOLTÉN             ","COSTA ARAUCANÍA","1","4",181,170,351
"2022",6348,"0","TOLTÉN             ","COSTA ARAUCANÍA","1","4",192,174,366
"2023",6348,"0","TOLTÉN             ","COSTA ARAUCANÍA","1","4",222,208,430
"2024",6348,"0","TOLTÉN             ","COSTA ARAUCANÍA","1","4",225,207,432
"2017",6349,"0","TOLTÉN             ","COSTA ARAUCANÍA","1","4",148,167,315
"2018",6349,"0","TOLTÉN             ","COSTA ARAUCANÍA","1","4",164,161,325
"2019",6349,"0","TOLTÉN             ","COSTA ARAUCANÍA","1","4",150,167,317
"2020",6349,"0","TOLTÉN             ","COSTA ARAUCANÍA","1","4",145,151,296
"2021",6349,"0","TOLTÉN             ","COSTA ARAUCANÍA","1","4",141,130,271
"2022",6349,"0","TOLTÉN             ","COSTA ARAUCANÍA","1","4",146,138,284
"2023",6349,"0","TOLTÉN             ","COSTA ARAUCANÍA","1","4",137,132,269
"2024",6349,"0","TOLTÉN             ","COSTA ARAUCANÍA","1","4",135,118,253
"2017",6350,"0","TOLTÉN             ","COSTA ARAUCANÍA","1","4",103,95,198
"2018",6350,"0","TOLTÉN             ","COSTA ARAUCANÍA","1","4",110,97,207
"2019",6350,"0","TOLTÉN             ","COSTA ARAUCANÍA","1","4",110,93,203
"2020",6350,"0","TOLTÉN             ","COSTA ARAUCANÍA","1","4",102,85,187
"2021",6350,"0","TOLTÉN             ","COSTA ARAUCANÍA","1","4",97,82,179
"2022",6350,"0","TOLTÉN             ","COSTA ARAUCANÍA","1","4",87,91,178
"2023",6350,"0","TOLTÉN             ","COSTA ARAUCANÍA","1","4",94,91,185
"2024",6350,"0","TOLTÉN             ","COSTA ARAUCANÍA","1","4",88,73,161
"2017",6351,"1","TOLTÉN             ","COSTA ARAUCANÍA","1","4",53,75,128
"2018",6351,"1","TOLTÉN             ","COSTA ARAUCANÍA","1","4",54,71,125
"2019",6351,"1","TOLTÉN             ","COSTA ARAUCANÍA","1","4",61,69,130
"2020",6351,"1","TOLTÉN             ","COSTA ARAUCANÍA","1","4",53,72,125
"2021",6351,"1","TOLTÉN             ","COSTA ARAUCANÍA","1","4",66,72,138
"2022",6351,"1","TOLTÉN             ","COSTA ARAUCANÍA","1","4",76,69,145
"2023",6351,"1","TOLTÉN             ","COSTA ARAUCANÍA","1","4",64,59,123
"2024",6351,"1","TOLTÉN             ","COSTA ARAUCANÍA","1","4",60,53,113
"2017",6352,"0","TOLTÉN             ","COSTA ARAUCANÍA","1","4",74,46,120
"2018",6352,"0","TOLTÉN             ","COSTA ARAUCANÍA","1","4",81,51,132
"2019",6352,"0","TOLTÉN             ","COSTA ARAUCANÍA","1","4",70,55,125
"2020",6352,"0","TOLTÉN             ","COSTA ARAUCANÍA","1","4",62,50,112
"2021",6352,"0","TOLTÉN             ","COSTA ARAUCANÍA","1","4",65,48,113
"2022",6352,"0","TOLTÉN             ","COSTA ARAUCANÍA","1","4",52,43,95
"2023",6352,"0","TOLTÉN             ","COSTA ARAUCANÍA","1","4",51,39,90
"2024",6352,"0","TOLTÉN             ","COSTA ARAUCANÍA","1","4",39,40,79
"2017",6353,"1","TOLTÉN             ","COSTA ARAUCANÍA","1","4",3,7,10
"2018",6353,"1","TOLTÉN             ","COSTA ARAUCANÍA","1","4",2,5,7
"2019",6353,"1","TOLTÉN             ","COSTA ARAUCANÍA","1","4",2,4,6
"2020",6353,"1","TOLTÉN             ","COSTA ARAUCANÍA","1","4",2,7,9
"2021",6353,"1","TOLTÉN             ","COSTA ARAUCANÍA","1","4",2,7,9
"2022",6353,"1","TOLTÉN             ","COSTA ARAUCANÍA","1","4",3,5,8
"2023",6353,"1","TOLTÉN             ","COSTA ARAUCANÍA","1","4",3,5,8
"2024",6353,"1","TOLTÉN             ","COSTA ARAUCANÍA","1","4",3,5,8
"2017",6358,"1","TEODORO SCHMIDT     ","COSTA ARAUCANÍA","1","4",4,3,7
"2018",6358,"1","TEODORO SCHMIDT     ","COSTA ARAUCANÍA","1","4",5,4,9
"2019",6358,"1","TEODORO SCHMIDT     ","COSTA ARAUCANÍA","1","4",6,2,8
"2020",6358,"1","TEODORO SCHMIDT     ","COSTA ARAUCANÍA","1","4",7,2,9
"2021",6358,"1","TEODORO SCHMIDT     ","COSTA ARAUCANÍA","1","4",8,5,13
"2022",6358,"1","TEODORO SCHMIDT     ","COSTA ARAUCANÍA","1","4",7,3,10
"2023",6358,"1","TEODORO SCHMIDT     ","COSTA ARAUCANÍA","1","4",3,2,5
"2024",6358,"1","TEODORO SCHMIDT     ","COSTA ARAUCANÍA","1","4",2,2,4
"2017",6361,"1","TEODORO SCHMIDT     ","COSTA ARAUCANÍA","1","4",2,0,2
"2018",6361,"1","TEODORO SCHMIDT     ","COSTA ARAUCANÍA","1","4",2,0,2
"2019",6361,"1","TEODORO SCHMIDT     ","COSTA ARAUCANÍA","1","4",2,0,2
"2020",6361,"1","TEODORO SCHMIDT     ","COSTA ARAUCANÍA","1","4",3,0,3
"2021",6361,"1","TEODORO SCHMIDT     ","COSTA ARAUCANÍA","1","4",2,0,2
"2022",6361,"1","TEODORO SCHMIDT     ","COSTA ARAUCANÍA","1","4",4,1,5
"2023",6361,"1","TEODORO SCHMIDT     ","COSTA ARAUCANÍA","1","4",3,0,3
"2024",6361,"1","TEODORO SCHMIDT     ","COSTA ARAUCANÍA","1","4",2,0,2
"2017",6363,"1","TOLTÉN             ","COSTA ARAUCANÍA","1","4",2,3,5
"2018",6363,"1","TOLTÉN             ","COSTA ARAUCANÍA","1","4",0,2,2
"2019",6363,"1","TOLTÉN             ","COSTA ARAUCANÍA","1","4",0,3,3
"2020",6363,"1","TOLTÉN             ","COSTA ARAUCANÍA","1","4",0,3,3
"2021",6363,"1","TOLTÉN             ","COSTA ARAUCANÍA","1","4",0,3,3
"2022",6363,"1","TOLTÉN             ","COSTA ARAUCANÍA","1","4",1,1,2
"2023",6363,"1","TOLTÉN             ","COSTA ARAUCANÍA","1","4",0,1,1
"2024",6363,"1","TOLTÉN             ","COSTA ARAUCANÍA","1","4",1,1,2
"2017",6370,"1","TOLTÉN             ","COSTA ARAUCANÍA","1","4",3,1,4
"2018",6370,"1","TOLTÉN             ","COSTA ARAUCANÍA","1","4",1,0,1
"2019",6370,"1","TOLTÉN             ","COSTA ARAUCANÍA","1","4",1,0,1
"2020",6370,"1","TOLTÉN             ","COSTA ARAUCANÍA","1","4",1,1,2
"2021",6370,"1","TOLTÉN             ","COSTA ARAUCANÍA","1","4",1,1,2
"2022",6370,"1","TOLTÉN             ","COSTA ARAUCANÍA","1","4",1,1,2
"2023",6370,"1","TOLTÉN             ","COSTA ARAUCANÍA","1","4",1,2,3
"2024",6370,"1","TOLTÉN             ","COSTA ARAUCANÍA","1","4",1,1,2
"2017",6371,"1","TOLTÉN             ","COSTA ARAUCANÍA","1","4",4,4,8
"2018",6371,"1","TOLTÉN             ","COSTA ARAUCANÍA","1","4",4,2,6
"2019",6371,"1","TOLTÉN             ","COSTA ARAUCANÍA","1","4",5,5,10
"2020",6371,"1","TOLTÉN             ","COSTA ARAUCANÍA","1","4",10,8,18
"2021",6371,"1","TOLTÉN             ","COSTA ARAUCANÍA","1","4",12,6,18
"2022",6371,"1","TOLTÉN             ","COSTA ARAUCANÍA","1","4",12,4,16
"2023",6371,"1","TOLTÉN             ","COSTA ARAUCANÍA","1","4",8,2,10
"2024",6371,"1","TOLTÉN             ","COSTA ARAUCANÍA","1","4",5,1,6
"2017",6373,"1","TEODORO SCHMIDT     ","COSTA ARAUCANÍA","1","4",13,7,20
"2018",6373,"1","TEODORO SCHMIDT     ","COSTA ARAUCANÍA","1","4",15,9,24
"2019",6373,"1","TEODORO SCHMIDT     ","COSTA ARAUCANÍA","1","4",12,14,26
"2020",6373,"1","TEODORO SCHMIDT     ","COSTA ARAUCANÍA","1","4",16,14,30
"2021",6373,"1","TEODORO SCHMIDT     ","COSTA ARAUCANÍA","1","4",16,19,35
"2022",6373,"1","TEODORO SCHMIDT     ","COSTA ARAUCANÍA","1","4",11,16,27
"2023",6373,"1","TEODORO SCHMIDT     ","COSTA ARAUCANÍA","1","4",11,20,31
"2024",6373,"1","TEODORO SCHMIDT     ","COSTA ARAUCANÍA","1","4",8,19,27
"2017",6374,"1","TOLTÉN             ","COSTA ARAUCANÍA","1","4",1,2,3
"2018",6374,"1","TOLTÉN             ","COSTA ARAUCANÍA","1","4",2,2,4
"2019",6374,"1","TOLTÉN             ","COSTA ARAUCANÍA","1","4",2,4,6
"2020",6374,"1","TOLTÉN             ","COSTA ARAUCANÍA","1","4",2,2,4
"2021",6374,"1","TOLTÉN             ","COSTA ARAUCANÍA","1","4",2,2,4
"2022",6374,"1","TOLTÉN             ","COSTA ARAUCANÍA","1","4",1,1,2
"2023",6374,"1","TOLTÉN             ","COSTA ARAUCANÍA","1","4",2,0,2
"2024",6374,"1","TOLTÉN             ","COSTA ARAUCANÍA","1","4",2,0,2
"2017",6377,"1","TOLTÉN             ","COSTA ARAUCANÍA","1","4",4,2,6
"2018",6377,"1","TOLTÉN             ","COSTA ARAUCANÍA","1","4",3,2,5
"2019",6377,"1","TOLTÉN             ","COSTA ARAUCANÍA","1","4",2,4,6
"2020",6377,"1","TOLTÉN             ","COSTA ARAUCANÍA","1","4",6,1,7
"2021",6377,"1","TOLTÉN             ","COSTA ARAUCANÍA","1","4",4,3,7
"2022",6377,"1","TOLTÉN             ","COSTA ARAUCANÍA","1","4",4,2,6
"2023",6377,"1","TOLTÉN             ","COSTA ARAUCANÍA","1","4",2,3,5
"2024",6377,"1","TOLTÉN             ","COSTA ARAUCANÍA","1","4",1,3,4
"2017",6397,"0","TEODORO SCHMIDT     ","COSTA ARAUCANÍA","1","4",90,94,184
"2018",6397,"0","TEODORO SCHMIDT     ","COSTA ARAUCANÍA","1","4",97,93,190
"2019",6397,"0","TEODORO SCHMIDT     ","COSTA ARAUCANÍA","1","4",105,100,205
"2020",6397,"0","TEODORO SCHMIDT     ","COSTA ARAUCANÍA","1","4",97,100,197
"2021",6397,"0","TEODORO SCHMIDT     ","COSTA ARAUCANÍA","1","4",97,107,204
"2022",6397,"0","TEODORO SCHMIDT     ","COSTA ARAUCANÍA","1","4",122,124,246
"2023",6397,"0","TEODORO SCHMIDT     ","COSTA ARAUCANÍA","1","4",133,132,265
"2024",6397,"0","TEODORO SCHMIDT     ","COSTA ARAUCANÍA","1","4",129,119,248
"2017",6398,"0","TEODORO SCHMIDT     ","COSTA ARAUCANÍA","1","4",189,192,381
"2018",6398,"0","TEODORO SCHMIDT     ","COSTA ARAUCANÍA","1","4",192,217,409
"2019",6398,"0","TEODORO SCHMIDT     ","COSTA ARAUCANÍA","1","4",195,233,428
"2020",6398,"0","TEODORO SCHMIDT     ","COSTA ARAUCANÍA","1","4",236,232,468
"2021",6398,"0","TEODORO SCHMIDT     ","COSTA ARAUCANÍA","1","4",240,243,483
"2022",6398,"0","TEODORO SCHMIDT     ","COSTA ARAUCANÍA","1","4",235,233,468
"2023",6398,"0","TEODORO SCHMIDT     ","COSTA ARAUCANÍA","1","4",234,236,470
"2024",6398,"0","TEODORO SCHMIDT     ","COSTA ARAUCANÍA","1","4",238,240,478
"2017",6399,"0","TEODORO SCHMIDT     ","COSTA ARAUCANÍA","1","4",120,129,249
"2018",6399,"0","TEODORO SCHMIDT     ","COSTA ARAUCANÍA","1","4",112,126,238
"2019",6399,"0","TEODORO SCHMIDT     ","COSTA ARAUCANÍA","1","4",117,120,237
"2020",6399,"0","TEODORO SCHMIDT     ","COSTA ARAUCANÍA","1","4",102,107,209
"2021",6399,"0","TEODORO SCHMIDT     ","COSTA ARAUCANÍA","1","4",98,107,205
"2022",6399,"0","TEODORO SCHMIDT     ","COSTA ARAUCANÍA","1","4",107,99,206
"2023",6399,"0","TEODORO SCHMIDT     ","COSTA ARAUCANÍA","1","4",103,108,211
"2024",6399,"0","TEODORO SCHMIDT     ","COSTA ARAUCANÍA","1","4",107,113,220
"2017",6400,"1","TEODORO SCHMIDT     ","COSTA ARAUCANÍA","1","4",1,2,3
"2018",6400,"1","TEODORO SCHMIDT     ","COSTA ARAUCANÍA","1","4",1,2,3
"2019",6400,"1","TEODORO SCHMIDT     ","COSTA ARAUCANÍA","1","4",0,2,2
"2020",6400,"1","TEODORO SCHMIDT     ","COSTA ARAUCANÍA","1","4",3,2,5
"2021",6400,"1","TEODORO SCHMIDT     ","COSTA ARAUCANÍA","1","4",5,4,9
"2022",6400,"1","TEODORO SCHMIDT     ","COSTA ARAUCANÍA","1","4",6,5,11
"2023",6400,"1","TEODORO SCHMIDT     ","COSTA ARAUCANÍA","1","4",6,5,11
"2024",6400,"1","TEODORO SCHMIDT     ","COSTA ARAUCANÍA","1","4",5,4,9
"2017",6407,"1","TEODORO SCHMIDT     ","COSTA ARAUCANÍA","1","4",2,3,5
"2018",6407,"1","TEODORO SCHMIDT     ","COSTA ARAUCANÍA","1","4",3,4,7
"2019",6407,"1","TEODORO SCHMIDT     ","COSTA ARAUCANÍA","1","4",4,3,7
"2020",6407,"1","TEODORO SCHMIDT     ","COSTA ARAUCANÍA","1","4",5,4,9
"2021",6407,"1","TEODORO SCHMIDT     ","COSTA ARAUCANÍA","1","4",3,4,7
"2022",6407,"1","TEODORO SCHMIDT     ","COSTA ARAUCANÍA","1","4",1,3,4
"2023",6407,"1","TEODORO SCHMIDT     ","COSTA ARAUCANÍA","1","4",2,5,7
"2024",6407,"1","TEODORO SCHMIDT     ","COSTA ARAUCANÍA","1","4",4,5,9
"2017",6410,"1","TEODORO SCHMIDT     ","COSTA ARAUCANÍA","1","4",1,0,1
"2018",6410,"1","TEODORO SCHMIDT     ","COSTA ARAUCANÍA","1","4",6,3,9
"2019",6410,"1","TEODORO SCHMIDT     ","COSTA ARAUCANÍA","1","4",7,2,9
"2020",6410,"1","TEODORO SCHMIDT     ","COSTA ARAUCANÍA","1","4",4,2,6
"2021",6410,"1","TEODORO SCHMIDT     ","COSTA ARAUCANÍA","1","4",3,1,4
"2022",6410,"1","TEODORO SCHMIDT     ","COSTA ARAUCANÍA","1","4",5,2,7
"2023",6410,"1","TEODORO SCHMIDT     ","COSTA ARAUCANÍA","1","4",6,2,8
"2024",6410,"1","TEODORO SCHMIDT     ","COSTA ARAUCANÍA","1","4",4,1,5
"2017",6411,"1","TEODORO SCHMIDT     ","COSTA ARAUCANÍA","1","4",5,11,16
"2018",6411,"1","TEODORO SCHMIDT     ","COSTA ARAUCANÍA","1","4",3,13,16
"2019",6411,"1","TEODORO SCHMIDT     ","COSTA ARAUCANÍA","1","4",6,10,16
"2020",6411,"1","TEODORO SCHMIDT     ","COSTA ARAUCANÍA","1","4",7,8,15
"2021",6411,"1","TEODORO SCHMIDT     ","COSTA ARAUCANÍA","1","4",8,10,18
"2022",6411,"1","TEODORO SCHMIDT     ","COSTA ARAUCANÍA","1","4",6,8,14
"2023",6411,"1","TEODORO SCHMIDT     ","COSTA ARAUCANÍA","1","4",7,8,15
"2024",6411,"1","TEODORO SCHMIDT     ","COSTA ARAUCANÍA","1","4",7,7,14
"2017",6413,"1","TEODORO SCHMIDT     ","COSTA ARAUCANÍA","1","4",5,5,10
"2018",6413,"1","TEODORO SCHMIDT     ","COSTA ARAUCANÍA","1","4",2,0,2
"2019",6413,"1","TEODORO SCHMIDT     ","COSTA ARAUCANÍA","1","4",2,2,4
"2020",6413,"1","TEODORO SCHMIDT     ","COSTA ARAUCANÍA","1","4",4,1,5
"2021",6413,"1","TEODORO SCHMIDT     ","COSTA ARAUCANÍA","1","4",4,1,5
"2022",6413,"1","TEODORO SCHMIDT     ","COSTA ARAUCANÍA","1","4",5,1,6
"2023",6413,"1","TEODORO SCHMIDT     ","COSTA ARAUCANÍA","1","4",3,1,4
"2024",6413,"1","TEODORO SCHMIDT     ","COSTA ARAUCANÍA","1","4",2,0,2
"2017",6415,"1","TEODORO SCHMIDT     ","COSTA ARAUCANÍA","1","4",2,7,9
"2018",6415,"1","TEODORO SCHMIDT     ","COSTA ARAUCANÍA","1","4",2,4,6
"2019",6415,"1","TEODORO SCHMIDT     ","COSTA ARAUCANÍA","1","4",3,5,8
"2020",6415,"1","TEODORO SCHMIDT     ","COSTA ARAUCANÍA","1","4",3,5,8
"2021",6415,"1","TEODORO SCHMIDT     ","COSTA ARAUCANÍA","1","4",6,4,10
"2022",6415,"1","TEODORO SCHMIDT     ","COSTA ARAUCANÍA","1","4",9,2,11
"2023",6415,"1","TEODORO SCHMIDT     ","COSTA ARAUCANÍA","1","4",3,0,3
"2024",6415,"1","TEODORO SCHMIDT     ","COSTA ARAUCANÍA","1","4",3,1,4
"2017",6452,"0","SAAVEDRA            ","COSTA ARAUCANÍA","1","4",210,227,437
"2018",6452,"0","SAAVEDRA            ","COSTA ARAUCANÍA","1","4",217,228,445
"2019",6452,"0","SAAVEDRA            ","COSTA ARAUCANÍA","1","4",209,220,429
"2020",6452,"0","SAAVEDRA            ","COSTA ARAUCANÍA","1","4",194,212,406
"2021",6452,"0","SAAVEDRA            ","COSTA ARAUCANÍA","1","4",212,232,444
"2022",6452,"0","SAAVEDRA            ","COSTA ARAUCANÍA","1","4",236,248,484
"2023",6452,"0","SAAVEDRA            ","COSTA ARAUCANÍA","1","4",245,236,481
"2024",6452,"0","SAAVEDRA            ","COSTA ARAUCANÍA","1","4",215,186,401
"2017",6454,"1","SAAVEDRA            ","COSTA ARAUCANÍA","1","4",33,33,66
"2018",6454,"1","SAAVEDRA            ","COSTA ARAUCANÍA","1","4",32,29,61
"2019",6454,"1","SAAVEDRA            ","COSTA ARAUCANÍA","1","4",34,33,67
"2020",6454,"1","SAAVEDRA            ","COSTA ARAUCANÍA","1","4",26,37,63
"2021",6454,"1","SAAVEDRA            ","COSTA ARAUCANÍA","1","4",26,36,62
"2022",6454,"1","SAAVEDRA            ","COSTA ARAUCANÍA","1","4",22,32,54
"2023",6454,"1","SAAVEDRA            ","COSTA ARAUCANÍA","1","4",31,32,63
"2024",6454,"1","SAAVEDRA            ","COSTA ARAUCANÍA","1","4",28,34,62
"2017",6455,"1","SAAVEDRA            ","COSTA ARAUCANÍA","1","4",23,28,51
"2018",6455,"1","SAAVEDRA            ","COSTA ARAUCANÍA","1","4",22,23,45
"2019",6455,"1","SAAVEDRA            ","COSTA ARAUCANÍA","1","4",22,21,43
"2020",6455,"1","SAAVEDRA            ","COSTA ARAUCANÍA","1","4",21,21,42
"2021",6455,"1","SAAVEDRA            ","COSTA ARAUCANÍA","1","4",28,29,57
"2022",6455,"1","SAAVEDRA            ","COSTA ARAUCANÍA","1","4",30,32,62
"2023",6455,"1","SAAVEDRA            ","COSTA ARAUCANÍA","1","4",38,27,65
"2024",6455,"1","SAAVEDRA            ","COSTA ARAUCANÍA","1","4",40,28,68
"2017",6456,"1","SAAVEDRA            ","COSTA ARAUCANÍA","1","4",15,24,39
"2018",6456,"1","SAAVEDRA            ","COSTA ARAUCANÍA","1","4",18,23,41
"2019",6456,"1","SAAVEDRA            ","COSTA ARAUCANÍA","1","4",15,23,38
"2020",6456,"1","SAAVEDRA            ","COSTA ARAUCANÍA","1","4",15,20,35
"2021",6456,"1","SAAVEDRA            ","COSTA ARAUCANÍA","1","4",18,22,40
"2022",6456,"1","SAAVEDRA            ","COSTA ARAUCANÍA","1","4",18,18,36
"2023",6456,"1","SAAVEDRA            ","COSTA ARAUCANÍA","1","4",14,18,32
"2024",6456,"1","SAAVEDRA            ","COSTA ARAUCANÍA","1","4",20,20,40
"2017",6457,"0","SAAVEDRA            ","COSTA ARAUCANÍA","1","4",82,89,171
"2018",6457,"0","SAAVEDRA            ","COSTA ARAUCANÍA","1","4",88,105,193
"2019",6457,"0","SAAVEDRA            ","COSTA ARAUCANÍA","1","4",94,107,201
"2020",6457,"0","SAAVEDRA            ","COSTA ARAUCANÍA","1","4",97,108,205
"2021",6457,"0","SAAVEDRA            ","COSTA ARAUCANÍA","1","4",106,107,213
"2022",6457,"0","SAAVEDRA            ","COSTA ARAUCANÍA","1","4",112,108,220
"2023",6457,"0","SAAVEDRA            ","COSTA ARAUCANÍA","1","4",107,116,223
"2024",6457,"0","SAAVEDRA            ","COSTA ARAUCANÍA","1","4",98,115,213
"2017",6458,"1","SAAVEDRA            ","COSTA ARAUCANÍA","1","4",22,18,40
"2018",6458,"1","SAAVEDRA            ","COSTA ARAUCANÍA","1","4",25,20,45
"2019",6458,"1","SAAVEDRA            ","COSTA ARAUCANÍA","1","4",23,18,41
"2020",6458,"1","SAAVEDRA            ","COSTA ARAUCANÍA","1","4",22,20,42
"2021",6458,"1","SAAVEDRA            ","COSTA ARAUCANÍA","1","4",19,21,40
"2022",6458,"1","SAAVEDRA            ","COSTA ARAUCANÍA","1","4",26,23,49
"2023",6458,"1","SAAVEDRA            ","COSTA ARAUCANÍA","1","4",23,18,41
"2024",6458,"1","SAAVEDRA            ","COSTA ARAUCANÍA","1","4",21,25,46
"2017",6459,"1","SAAVEDRA            ","COSTA ARAUCANÍA","1","4",41,29,70
"2018",6459,"1","SAAVEDRA            ","COSTA ARAUCANÍA","1","4",39,29,68
"2019",6459,"1","SAAVEDRA            ","COSTA ARAUCANÍA","1","4",40,28,68
"2020",6459,"1","SAAVEDRA            ","COSTA ARAUCANÍA","1","4",45,32,77
"2021",6459,"1","SAAVEDRA            ","COSTA ARAUCANÍA","1","4",44,34,78
"2022",6459,"1","SAAVEDRA            ","COSTA ARAUCANÍA","1","4",38,37,75
"2023",6459,"1","SAAVEDRA            ","COSTA ARAUCANÍA","1","4",34,38,72
"2024",6459,"1","SAAVEDRA            ","COSTA ARAUCANÍA","1","4",35,42,77
"2017",6495,"1","SAAVEDRA            ","COSTA ARAUCANÍA","1","4",15,31,46
"2018",6495,"1","SAAVEDRA            ","COSTA ARAUCANÍA","1","4",19,39,58
"2019",6495,"1","SAAVEDRA            ","COSTA ARAUCANÍA","1","4",17,30,47
"2020",6495,"1","SAAVEDRA            ","COSTA ARAUCANÍA","1","4",30,29,59
"2021",6495,"1","SAAVEDRA            ","COSTA ARAUCANÍA","1","4",31,31,62
"2022",6495,"1","SAAVEDRA            ","COSTA ARAUCANÍA","1","4",28,29,57
"2023",6495,"1","SAAVEDRA            ","COSTA ARAUCANÍA","1","4",25,30,55
"2024",6495,"1","SAAVEDRA            ","COSTA ARAUCANÍA","1","4",20,25,45
"2017",6497,"0","CARAHUE             ","COSTA ARAUCANÍA","1","4",514,495,1009
"2018",6497,"0","CARAHUE             ","COSTA ARAUCANÍA","1","4",434,395,829
"2019",6497,"0","CARAHUE             ","COSTA ARAUCANÍA","1","4",396,394,790
"2020",6497,"0","CARAHUE             ","COSTA ARAUCANÍA","1","4",393,371,764
"2021",6497,"0","CARAHUE             ","COSTA ARAUCANÍA","1","4",421,382,803
"2022",6497,"0","CARAHUE             ","COSTA ARAUCANÍA","1","4",433,383,816
"2023",6497,"0","CARAHUE             ","COSTA ARAUCANÍA","1","4",417,377,794
"2024",6497,"0","CARAHUE             ","COSTA ARAUCANÍA","1","4",422,390,812
"2017",6499,"0","CARAHUE             ","COSTA ARAUCANÍA","1","4",105,104,209
"2018",6499,"0","CARAHUE             ","COSTA ARAUCANÍA","1","4",120,122,242
"2019",6499,"0","CARAHUE             ","COSTA ARAUCANÍA","1","4",134,129,263
"2020",6499,"0","CARAHUE             ","COSTA ARAUCANÍA","1","4",131,144,275
"2021",6499,"0","CARAHUE             ","COSTA ARAUCANÍA","1","4",132,132,264
"2022",6499,"0","CARAHUE             ","COSTA ARAUCANÍA","1","4",131,141,272
"2023",6499,"0","CARAHUE             ","COSTA ARAUCANÍA","1","4",132,138,270
"2024",6499,"0","CARAHUE             ","COSTA ARAUCANÍA","1","4",122,136,258
"2017",6500,"0","CARAHUE             ","COSTA ARAUCANÍA","1","4",306,317,623
"2018",6500,"0","CARAHUE             ","COSTA ARAUCANÍA","1","4",447,462,909
"2019",6500,"0","CARAHUE             ","COSTA ARAUCANÍA","1","4",546,519,1065
"2020",6500,"0","CARAHUE             ","COSTA ARAUCANÍA","1","4",598,558,1156
"2021",6500,"0","CARAHUE             ","COSTA ARAUCANÍA","1","4",606,580,1186
"2022",6500,"0","CARAHUE             ","COSTA ARAUCANÍA","1","4",609,596,1205
"2023",6500,"0","CARAHUE             ","COSTA ARAUCANÍA","1","4",617,602,1219
"2024",6500,"0","CARAHUE             ","COSTA ARAUCANÍA","1","4",584,610,1194
"2017",6501,"0","CARAHUE             ","COSTA ARAUCANÍA","1","4",312,274,586
"2018",6501,"0","CARAHUE             ","COSTA ARAUCANÍA","1","4",308,300,608
"2019",6501,"0","CARAHUE             ","COSTA ARAUCANÍA","1","4",305,296,601
"2020",6501,"0","CARAHUE             ","COSTA ARAUCANÍA","1","4",298,294,592
"2021",6501,"0","CARAHUE             ","COSTA ARAUCANÍA","1","4",292,316,608
"2022",6501,"0","CARAHUE             ","COSTA ARAUCANÍA","1","4",301,320,621
"2023",6501,"0","CARAHUE             ","COSTA ARAUCANÍA","1","4",288,299,587
"2024",6501,"0","CARAHUE             ","COSTA ARAUCANÍA","1","4",296,271,567
"2017",6502,"0","CARAHUE             ","COSTA ARAUCANÍA","1","4",79,69,148
"2018",6502,"0","CARAHUE             ","COSTA ARAUCANÍA","1","4",78,69,147
"2019",6502,"0","CARAHUE             ","COSTA ARAUCANÍA","1","4",75,63,138
"2020",6502,"0","CARAHUE             ","COSTA ARAUCANÍA","1","4",75,60,135
"2021",6502,"0","CARAHUE             ","COSTA ARAUCANÍA","1","4",76,74,150
"2022",6502,"0","CARAHUE             ","COSTA ARAUCANÍA","1","4",69,63,132
"2023",6502,"0","CARAHUE             ","COSTA ARAUCANÍA","1","4",67,64,131
"2024",6502,"0","CARAHUE             ","COSTA ARAUCANÍA","1","4",64,64,128
"2017",6504,"1","CARAHUE             ","COSTA ARAUCANÍA","1","4",59,62,121
"2018",6504,"1","CARAHUE             ","COSTA ARAUCANÍA","1","4",56,63,119
"2019",6504,"1","CARAHUE             ","COSTA ARAUCANÍA","1","4",66,61,127
"2020",6504,"1","CARAHUE             ","COSTA ARAUCANÍA","1","4",64,63,127
"2021",6504,"1","CARAHUE             ","COSTA ARAUCANÍA","1","4",78,69,147
"2022",6504,"1","CARAHUE             ","COSTA ARAUCANÍA","1","4",67,69,136
"2023",6504,"1","CARAHUE             ","COSTA ARAUCANÍA","1","4",57,47,104
"2024",6504,"1","CARAHUE             ","COSTA ARAUCANÍA","1","4",56,48,104
"2017",6506,"1","CARAHUE             ","COSTA ARAUCANÍA","1","4",3,3,6
"2018",6506,"1","CARAHUE             ","COSTA ARAUCANÍA","1","4",3,3,6
"2019",6506,"1","CARAHUE             ","COSTA ARAUCANÍA","1","4",2,2,4
"2020",6506,"1","CARAHUE             ","COSTA ARAUCANÍA","1","4",2,2,4
"2021",6506,"1","CARAHUE             ","COSTA ARAUCANÍA","1","4",2,1,3
"2022",6506,"1","CARAHUE             ","COSTA ARAUCANÍA","1","4",3,1,4
"2023",6506,"1","CARAHUE             ","COSTA ARAUCANÍA","1","4",1,0,1
"2024",6506,"1","CARAHUE             ","COSTA ARAUCANÍA","1","4",1,0,1
"2017",6508,"1","CARAHUE             ","COSTA ARAUCANÍA","1","4",4,4,8
"2018",6508,"1","CARAHUE             ","COSTA ARAUCANÍA","1","4",3,4,7
"2019",6508,"1","CARAHUE             ","COSTA ARAUCANÍA","1","4",5,6,11
"2020",6508,"1","CARAHUE             ","COSTA ARAUCANÍA","1","4",3,5,8
"2021",6508,"1","CARAHUE             ","COSTA ARAUCANÍA","1","4",2,3,5
"2022",6508,"1","CARAHUE             ","COSTA ARAUCANÍA","1","4",1,4,5
"2023",6508,"1","CARAHUE             ","COSTA ARAUCANÍA","1","4",2,1,3
"2024",6508,"1","CARAHUE             ","COSTA ARAUCANÍA","1","4",4,1,5
"2017",6510,"1","CARAHUE             ","COSTA ARAUCANÍA","1","4",2,0,2
"2018",6510,"1","CARAHUE             ","COSTA ARAUCANÍA","1","4",1,0,1
"2019",6510,"1","CARAHUE             ","COSTA ARAUCANÍA","1","4",1,0,1
"2020",6510,"1","CARAHUE             ","COSTA ARAUCANÍA","1","4",2,0,2
"2021",6510,"1","CARAHUE             ","COSTA ARAUCANÍA","1","4",1,0,1
"2022",6510,"1","CARAHUE             ","COSTA ARAUCANÍA","1","4",2,3,5
"2023",6510,"1","CARAHUE             ","COSTA ARAUCANÍA","1","4",2,1,3
"2024",6510,"1","CARAHUE             ","COSTA ARAUCANÍA","1","4",2,0,2
"2017",6512,"1","CARAHUE             ","COSTA ARAUCANÍA","1","4",4,3,7
"2018",6512,"1","CARAHUE             ","COSTA ARAUCANÍA","1","4",2,0,2
"2019",6512,"1","CARAHUE             ","COSTA ARAUCANÍA","1","4",2,2,4
"2020",6512,"1","CARAHUE             ","COSTA ARAUCANÍA","1","4",2,2,4
"2021",6512,"1","CARAHUE             ","COSTA ARAUCANÍA","1","4",4,2,6
"2022",6512,"1","CARAHUE             ","COSTA ARAUCANÍA","1","4",3,0,3
"2023",6512,"1","CARAHUE             ","COSTA ARAUCANÍA","1","4",2,0,2
"2024",6512,"1","CARAHUE             ","COSTA ARAUCANÍA","1","4",1,0,1
"2017",6515,"1","CARAHUE             ","COSTA ARAUCANÍA","1","4",4,5,9
"2018",6515,"1","CARAHUE             ","COSTA ARAUCANÍA","1","4",1,1,2
"2019",6515,"1","CARAHUE             ","COSTA ARAUCANÍA","1","4",1,2,3
"2020",6515,"1","CARAHUE             ","COSTA ARAUCANÍA","1","4",1,1,2
"2021",6515,"1","CARAHUE             ","COSTA ARAUCANÍA","1","4",1,2,3
"2022",6515,"1","CARAHUE             ","COSTA ARAUCANÍA","1","4",0,3,3
"2023",6515,"1","CARAHUE             ","COSTA ARAUCANÍA","1","4",0,4,4
"2024",6515,"1","CARAHUE             ","COSTA ARAUCANÍA","1","4",0,3,3
"2017",6521,"1","CARAHUE             ","COSTA ARAUCANÍA","1","4",1,2,3
"2018",6521,"1","CARAHUE             ","COSTA ARAUCANÍA","1","4",0,2,2
"2019",6521,"1","CARAHUE             ","COSTA ARAUCANÍA","1","4",0,2,2
"2020",6521,"1","CARAHUE             ","COSTA ARAUCANÍA","1","4",0,2,2
"2021",6521,"1","CARAHUE             ","COSTA ARAUCANÍA","1","4",1,2,3
"2022",6521,"1","CARAHUE             ","COSTA ARAUCANÍA","1","4",1,1,2
"2023",6521,"1","CARAHUE             ","COSTA ARAUCANÍA","1","4",2,3,5
"2024",6521,"1","CARAHUE             ","COSTA ARAUCANÍA","1","4",0,3,3
"2017",6523,"1","CARAHUE             ","COSTA ARAUCANÍA","1","4",1,0,1
"2018",6523,"1","CARAHUE             ","COSTA ARAUCANÍA","1","4",1,1,2
"2019",6523,"1","CARAHUE             ","COSTA ARAUCANÍA","1","4",1,1,2
"2020",6523,"1","CARAHUE             ","COSTA ARAUCANÍA","1","4",1,1,2
"2021",6523,"1","CARAHUE             ","COSTA ARAUCANÍA","1","4",1,2,3
"2022",6523,"1","CARAHUE             ","COSTA ARAUCANÍA","1","4",1,2,3
"2023",6523,"1","CARAHUE             ","COSTA ARAUCANÍA","1","4",2,2,4
"2024",6523,"1","CARAHUE             ","COSTA ARAUCANÍA","1","4",1,0,1
"2017",6524,"1","CARAHUE             ","COSTA ARAUCANÍA","1","4",4,2,6
"2018",6524,"1","CARAHUE             ","COSTA ARAUCANÍA","1","4",2,0,2
"2019",6524,"1","CARAHUE             ","COSTA ARAUCANÍA","1","4",2,0,2
"2020",6524,"1","CARAHUE             ","COSTA ARAUCANÍA","1","4",2,0,2
"2021",6524,"1","CARAHUE             ","COSTA ARAUCANÍA","1","4",2,2,4
"2022",6524,"1","CARAHUE             ","COSTA ARAUCANÍA","1","4",0,2,2
"2023",6524,"1","CARAHUE             ","COSTA ARAUCANÍA","1","4",0,2,2
"2024",6524,"1","CARAHUE             ","COSTA ARAUCANÍA","1","4",0,2,2
"2017",6528,"1","CARAHUE             ","COSTA ARAUCANÍA","1","4",20,27,47
"2018",6528,"1","CARAHUE             ","COSTA ARAUCANÍA","1","4",18,32,50
"2019",6528,"1","CARAHUE             ","COSTA ARAUCANÍA","1","4",16,25,41
"2020",6528,"1","CARAHUE             ","COSTA ARAUCANÍA","1","4",19,22,41
"2021",6528,"1","CARAHUE             ","COSTA ARAUCANÍA","1","4",25,22,47
"2022",6528,"1","CARAHUE             ","COSTA ARAUCANÍA","1","4",22,27,49
"2023",6528,"1","CARAHUE             ","COSTA ARAUCANÍA","1","4",14,22,36
"2024",6528,"1","CARAHUE             ","COSTA ARAUCANÍA","1","4",15,18,33
"2017",6529,"1","CARAHUE             ","COSTA ARAUCANÍA","1","4",3,1,4
"2018",6529,"1","CARAHUE             ","COSTA ARAUCANÍA","1","4",2,0,2
"2019",6529,"1","CARAHUE             ","COSTA ARAUCANÍA","1","4",2,0,2
"2020",6529,"1","CARAHUE             ","COSTA ARAUCANÍA","1","4",3,0,3
"2021",6529,"1","CARAHUE             ","COSTA ARAUCANÍA","1","4",3,0,3
"2022",6529,"1","CARAHUE             ","COSTA ARAUCANÍA","1","4",7,0,7
"2023",6529,"1","CARAHUE             ","COSTA ARAUCANÍA","1","4",3,0,3
"2024",6529,"1","CARAHUE             ","COSTA ARAUCANÍA","1","4",3,0,3
"2017",6539,"1","CARAHUE             ","COSTA ARAUCANÍA","1","4",8,9,17
"2018",6539,"1","CARAHUE             ","COSTA ARAUCANÍA","1","4",10,7,17
"2019",6539,"1","CARAHUE             ","COSTA ARAUCANÍA","1","4",8,3,11
"2020",6539,"1","CARAHUE             ","COSTA ARAUCANÍA","1","4",10,4,14
"2021",6539,"1","CARAHUE             ","COSTA ARAUCANÍA","1","4",8,5,13
"2022",6539,"1","CARAHUE             ","COSTA ARAUCANÍA","1","4",10,7,17
"2023",6539,"1","CARAHUE             ","COSTA ARAUCANÍA","1","4",8,7,15
"2024",6539,"1","CARAHUE             ","COSTA ARAUCANÍA","1","4",7,8,15
"2017",6585,"0","NUEVA IMPERIAL      ","COSTA ARAUCANÍA","1","4",434,486,920
"2018",6585,"0","NUEVA IMPERIAL      ","COSTA ARAUCANÍA","1","4",418,490,908
"2019",6585,"0","NUEVA IMPERIAL      ","COSTA ARAUCANÍA","1","4",423,478,901
"2020",6585,"0","NUEVA IMPERIAL      ","COSTA ARAUCANÍA","1","4",397,460,857
"2021",6585,"0","NUEVA IMPERIAL      ","COSTA ARAUCANÍA","1","4",391,474,865
"2022",6585,"0","NUEVA IMPERIAL      ","COSTA ARAUCANÍA","1","4",387,450,837
"2023",6585,"0","NUEVA IMPERIAL      ","COSTA ARAUCANÍA","1","4",383,444,827
"2024",6585,"0","NUEVA IMPERIAL      ","COSTA ARAUCANÍA","1","4",385,439,824
"2017",6587,"0","NUEVA IMPERIAL      ","COSTA ARAUCANÍA","1","4",321,285,606
"2018",6587,"0","NUEVA IMPERIAL      ","COSTA ARAUCANÍA","1","4",298,268,566
"2019",6587,"0","NUEVA IMPERIAL      ","COSTA ARAUCANÍA","1","4",285,264,549
"2020",6587,"0","NUEVA IMPERIAL      ","COSTA ARAUCANÍA","1","4",285,256,541
"2021",6587,"0","NUEVA IMPERIAL      ","COSTA ARAUCANÍA","1","4",246,238,484
"2022",6587,"0","NUEVA IMPERIAL      ","COSTA ARAUCANÍA","1","4",259,240,499
"2023",6587,"0","NUEVA IMPERIAL      ","COSTA ARAUCANÍA","1","4",232,210,442
"2024",6587,"0","NUEVA IMPERIAL      ","COSTA ARAUCANÍA","1","4",209,201,410
"2017",6588,"0","NUEVA IMPERIAL      ","COSTA ARAUCANÍA","1","4",111,108,219
"2018",6588,"0","NUEVA IMPERIAL      ","COSTA ARAUCANÍA","1","4",121,121,242
"2019",6588,"0","NUEVA IMPERIAL      ","COSTA ARAUCANÍA","1","4",120,127,247
"2020",6588,"0","NUEVA IMPERIAL      ","COSTA ARAUCANÍA","1","4",135,120,255
"2021",6588,"0","NUEVA IMPERIAL      ","COSTA ARAUCANÍA","1","4",134,124,258
"2022",6588,"0","NUEVA IMPERIAL      ","COSTA ARAUCANÍA","1","4",111,126,237
"2023",6588,"0","NUEVA IMPERIAL      ","COSTA ARAUCANÍA","1","4",106,115,221
"2024",6588,"0","NUEVA IMPERIAL      ","COSTA ARAUCANÍA","1","4",112,120,232
"2017",6589,"0","NUEVA IMPERIAL      ","COSTA ARAUCANÍA","1","4",103,106,209
"2018",6589,"0","NUEVA IMPERIAL      ","COSTA ARAUCANÍA","1","4",108,106,214
"2019",6589,"0","NUEVA IMPERIAL      ","COSTA ARAUCANÍA","1","4",119,124,243
"2020",6589,"0","NUEVA IMPERIAL      ","COSTA ARAUCANÍA","1","4",117,138,255
"2021",6589,"0","NUEVA IMPERIAL      ","COSTA ARAUCANÍA","1","4",128,133,261
"2022",6589,"0","NUEVA IMPERIAL      ","COSTA ARAUCANÍA","1","4",130,142,272
"2023",6589,"0","NUEVA IMPERIAL      ","COSTA ARAUCANÍA","1","4",138,137,275
"2024",6589,"0","NUEVA IMPERIAL      ","COSTA ARAUCANÍA","1","4",129,135,264
"2017",6590,"0","NUEVA IMPERIAL      ","COSTA ARAUCANÍA","1","4",44,19,63
"2018",6590,"0","NUEVA IMPERIAL      ","COSTA ARAUCANÍA","1","4",37,19,56
"2019",6590,"0","NUEVA IMPERIAL      ","COSTA ARAUCANÍA","1","4",38,17,55
"2020",6590,"0","NUEVA IMPERIAL      ","COSTA ARAUCANÍA","1","4",38,20,58
"2021",6590,"0","NUEVA IMPERIAL      ","COSTA ARAUCANÍA","1","4",41,19,60
"2022",6590,"0","NUEVA IMPERIAL      ","COSTA ARAUCANÍA","1","4",41,19,60
"2023",6590,"0","NUEVA IMPERIAL      ","COSTA ARAUCANÍA","1","4",42,16,58
"2024",6590,"0","NUEVA IMPERIAL      ","COSTA ARAUCANÍA","1","4",47,16,63
"2017",6591,"0","NUEVA IMPERIAL      ","COSTA ARAUCANÍA","1","4",26,0,26
"2018",6591,"0","NUEVA IMPERIAL      ","COSTA ARAUCANÍA","1","4",26,0,26
"2019",6591,"0","NUEVA IMPERIAL      ","COSTA ARAUCANÍA","1","4",22,0,22
"2020",6591,"0","NUEVA IMPERIAL      ","COSTA ARAUCANÍA","1","4",19,0,19
"2021",6591,"0","NUEVA IMPERIAL      ","COSTA ARAUCANÍA","1","4",14,0,14
"2022",6591,"0","NUEVA IMPERIAL      ","COSTA ARAUCANÍA","1","4",10,0,10
"2023",6591,"0","NUEVA IMPERIAL      ","COSTA ARAUCANÍA","1","4",18,0,18
"2024",6591,"0","NUEVA IMPERIAL      ","COSTA ARAUCANÍA","1","4",24,0,24
"2017",6593,"1","NUEVA IMPERIAL      ","COSTA ARAUCANÍA","1","4",41,51,92
"2018",6593,"1","NUEVA IMPERIAL      ","COSTA ARAUCANÍA","1","4",42,54,96
"2019",6593,"1","NUEVA IMPERIAL      ","COSTA ARAUCANÍA","1","4",43,52,95
"2020",6593,"1","NUEVA IMPERIAL      ","COSTA ARAUCANÍA","1","4",44,56,100
"2021",6593,"1","NUEVA IMPERIAL      ","COSTA ARAUCANÍA","1","4",45,58,103
"2022",6593,"1","NUEVA IMPERIAL      ","COSTA ARAUCANÍA","1","4",47,59,106
"2023",6593,"1","NUEVA IMPERIAL      ","COSTA ARAUCANÍA","1","4",53,63,116
"2024",6593,"1","NUEVA IMPERIAL      ","COSTA ARAUCANÍA","1","4",56,68,124
"2017",6600,"1","NUEVA IMPERIAL      ","COSTA ARAUCANÍA","1","4",6,4,10
"2018",6600,"1","NUEVA IMPERIAL      ","COSTA ARAUCANÍA","1","4",4,5,9
"2019",6600,"1","NUEVA IMPERIAL      ","COSTA ARAUCANÍA","1","4",1,5,6
"2020",6600,"1","NUEVA IMPERIAL      ","COSTA ARAUCANÍA","1","4",3,5,8
"2021",6600,"1","NUEVA IMPERIAL      ","COSTA ARAUCANÍA","1","4",1,4,5
"2022",6600,"1","NUEVA IMPERIAL      ","COSTA ARAUCANÍA","1","4",3,5,8
"2023",6600,"1","NUEVA IMPERIAL      ","COSTA ARAUCANÍA","1","4",3,5,8
"2024",6600,"1","NUEVA IMPERIAL      ","COSTA ARAUCANÍA","1","4",3,4,7
"2017",6602,"1","NUEVA IMPERIAL      ","COSTA ARAUCANÍA","1","4",4,5,9
"2018",6602,"1","NUEVA IMPERIAL      ","COSTA ARAUCANÍA","1","4",5,6,11
"2019",6602,"1","NUEVA IMPERIAL      ","COSTA ARAUCANÍA","1","4",5,4,9
"2020",6602,"1","NUEVA IMPERIAL      ","COSTA ARAUCANÍA","1","4",6,4,10
"2021",6602,"1","NUEVA IMPERIAL      ","COSTA ARAUCANÍA","1","4",9,6,15
"2022",6602,"1","NUEVA IMPERIAL      ","COSTA ARAUCANÍA","1","4",7,11,18
"2023",6602,"1","NUEVA IMPERIAL      ","COSTA ARAUCANÍA","1","4",4,8,12
"2024",6602,"1","NUEVA IMPERIAL      ","COSTA ARAUCANÍA","1","4",3,8,11
"2017",6605,"1","NUEVA IMPERIAL      ","COSTA ARAUCANÍA","1","4",10,5,15
"2018",6605,"1","NUEVA IMPERIAL      ","COSTA ARAUCANÍA","1","4",10,5,15
"2019",6605,"1","NUEVA IMPERIAL      ","COSTA ARAUCANÍA","1","4",8,9,17
"2020",6605,"1","NUEVA IMPERIAL      ","COSTA ARAUCANÍA","1","4",11,9,20
"2021",6605,"1","NUEVA IMPERIAL      ","COSTA ARAUCANÍA","1","4",9,8,17
"2022",6605,"1","NUEVA IMPERIAL      ","COSTA ARAUCANÍA","1","4",11,8,19
"2023",6605,"1","NUEVA IMPERIAL      ","COSTA ARAUCANÍA","1","4",8,9,17
"2024",6605,"1","NUEVA IMPERIAL      ","COSTA ARAUCANÍA","1","4",8,7,15
"2017",6608,"1","NUEVA IMPERIAL      ","COSTA ARAUCANÍA","1","4",8,13,21
"2018",6608,"1","NUEVA IMPERIAL      ","COSTA ARAUCANÍA","1","4",9,13,22
"2019",6608,"1","NUEVA IMPERIAL      ","COSTA ARAUCANÍA","1","4",10,15,25
"2020",6608,"1","NUEVA IMPERIAL      ","COSTA ARAUCANÍA","1","4",11,12,23
"2021",6608,"1","NUEVA IMPERIAL      ","COSTA ARAUCANÍA","1","4",10,15,25
"2022",6608,"1","NUEVA IMPERIAL      ","COSTA ARAUCANÍA","1","4",10,13,23
"2023",6608,"1","NUEVA IMPERIAL      ","COSTA ARAUCANÍA","1","4",13,12,25
"2024",6608,"1","NUEVA IMPERIAL      ","COSTA ARAUCANÍA","1","4",13,9,22
"2017",6611,"1","NUEVA IMPERIAL      ","COSTA ARAUCANÍA","1","4",14,12,26
"2018",6611,"1","NUEVA IMPERIAL      ","COSTA ARAUCANÍA","1","4",15,9,24
"2019",6611,"1","NUEVA IMPERIAL      ","COSTA ARAUCANÍA","1","4",12,10,22
"2020",6611,"1","NUEVA IMPERIAL      ","COSTA ARAUCANÍA","1","4",14,15,29
"2021",6611,"1","NUEVA IMPERIAL      ","COSTA ARAUCANÍA","1","4",13,16,29
"2022",6611,"1","NUEVA IMPERIAL      ","COSTA ARAUCANÍA","1","4",15,12,27
"2023",6611,"1","NUEVA IMPERIAL      ","COSTA ARAUCANÍA","1","4",9,14,23
"2024",6611,"1","NUEVA IMPERIAL      ","COSTA ARAUCANÍA","1","4",7,10,17
"2017",6623,"1","NUEVA IMPERIAL      ","COSTA ARAUCANÍA","1","4",16,12,28
"2018",6623,"1","NUEVA IMPERIAL      ","COSTA ARAUCANÍA","1","4",15,13,28
"2019",6623,"1","NUEVA IMPERIAL      ","COSTA ARAUCANÍA","1","4",12,12,24
"2020",6623,"1","NUEVA IMPERIAL      ","COSTA ARAUCANÍA","1","4",11,12,23
"2021",6623,"1","NUEVA IMPERIAL      ","COSTA ARAUCANÍA","1","4",9,8,17
"2022",6623,"1","NUEVA IMPERIAL      ","COSTA ARAUCANÍA","1","4",13,10,23
"2023",6623,"1","NUEVA IMPERIAL      ","COSTA ARAUCANÍA","1","4",9,12,21
"2024",6623,"1","NUEVA IMPERIAL      ","COSTA ARAUCANÍA","1","4",10,10,20
"2017",6628,"1","NUEVA IMPERIAL      ","COSTA ARAUCANÍA","1","4",9,10,19
"2018",6628,"1","NUEVA IMPERIAL      ","COSTA ARAUCANÍA","1","4",9,13,22
"2019",6628,"1","NUEVA IMPERIAL      ","COSTA ARAUCANÍA","1","4",6,12,18
"2020",6628,"1","NUEVA IMPERIAL      ","COSTA ARAUCANÍA","1","4",7,10,17
"2021",6628,"1","NUEVA IMPERIAL      ","COSTA ARAUCANÍA","1","4",13,14,27
"2022",6628,"1","NUEVA IMPERIAL      ","COSTA ARAUCANÍA","1","4",10,10,20
"2023",6628,"1","NUEVA IMPERIAL      ","COSTA ARAUCANÍA","1","4",10,7,17
"2024",6628,"1","NUEVA IMPERIAL      ","COSTA ARAUCANÍA","1","4",9,6,15
"2017",6633,"1","NUEVA IMPERIAL      ","COSTA ARAUCANÍA","1","4",22,23,45
"2018",6633,"1","NUEVA IMPERIAL      ","COSTA ARAUCANÍA","1","4",13,16,29
"2019",6633,"1","NUEVA IMPERIAL      ","COSTA ARAUCANÍA","1","4",11,23,34
"2020",6633,"1","NUEVA IMPERIAL      ","COSTA ARAUCANÍA","1","4",15,20,35
"2021",6633,"1","NUEVA IMPERIAL      ","COSTA ARAUCANÍA","1","4",17,17,34
"2022",6633,"1","NUEVA IMPERIAL      ","COSTA ARAUCANÍA","1","4",22,15,37
"2023",6633,"1","NUEVA IMPERIAL      ","COSTA ARAUCANÍA","1","4",30,19,49
"2024",6633,"1","NUEVA IMPERIAL      ","COSTA ARAUCANÍA","1","4",23,26,49
"2017",6639,"1","NUEVA IMPERIAL      ","COSTA ARAUCANÍA","1","4",20,21,41
"2018",6639,"1","NUEVA IMPERIAL      ","COSTA ARAUCANÍA","1","4",16,20,36
"2019",6639,"1","NUEVA IMPERIAL      ","COSTA ARAUCANÍA","1","4",11,16,27
"2020",6639,"1","NUEVA IMPERIAL      ","COSTA ARAUCANÍA","1","4",12,17,29
"2021",6639,"1","NUEVA IMPERIAL      ","COSTA ARAUCANÍA","1","4",17,18,35
"2022",6639,"1","NUEVA IMPERIAL      ","COSTA ARAUCANÍA","1","4",16,17,33
"2023",6639,"1","NUEVA IMPERIAL      ","COSTA ARAUCANÍA","1","4",14,17,31
"2024",6639,"1","NUEVA IMPERIAL      ","COSTA ARAUCANÍA","1","4",14,19,33
"2017",9072,"0","MACUL               ","GABRIELA MISTRAL","1","6",310,258,568
"2018",9072,"0","MACUL               ","GABRIELA MISTRAL","1","6",303,238,541
"2019",9072,"0","MACUL               ","GABRIELA MISTRAL","1","6",332,250,582
"2020",9072,"0","MACUL               ","GABRIELA MISTRAL","1","6",317,252,569
"2021",9072,"0","MACUL               ","GABRIELA MISTRAL","1","6",281,244,525
"2022",9072,"0","MACUL               ","GABRIELA MISTRAL","1","6",285,248,533
"2023",9072,"0","MACUL               ","GABRIELA MISTRAL","1","6",254,221,475
"2024",9072,"0","MACUL               ","GABRIELA MISTRAL","1","6",256,229,485
"2017",9075,"0","MACUL               ","GABRIELA MISTRAL","1","6",152,100,252
"2018",9075,"0","MACUL               ","GABRIELA MISTRAL","1","6",163,120,283
"2019",9075,"0","MACUL               ","GABRIELA MISTRAL","1","6",129,122,251
"2020",9075,"0","MACUL               ","GABRIELA MISTRAL","1","6",94,103,197
"2021",9075,"0","MACUL               ","GABRIELA MISTRAL","1","6",77,85,162
"2022",9075,"0","MACUL               ","GABRIELA MISTRAL","1","6",59,54,113
"2023",9075,"0","MACUL               ","GABRIELA MISTRAL","1","6",83,61,144
"2024",9075,"0","MACUL               ","GABRIELA MISTRAL","1","6",85,59,144
"2017",9085,"0","MACUL               ","GABRIELA MISTRAL","1","6",221,164,385
"2018",9085,"0","MACUL               ","GABRIELA MISTRAL","1","6",278,209,487
"2019",9085,"0","MACUL               ","GABRIELA MISTRAL","1","6",298,223,521
"2020",9085,"0","MACUL               ","GABRIELA MISTRAL","1","6",292,219,511
"2021",9085,"0","MACUL               ","GABRIELA MISTRAL","1","6",312,254,566
"2022",9085,"0","MACUL               ","GABRIELA MISTRAL","1","6",318,251,569
"2023",9085,"0","MACUL               ","GABRIELA MISTRAL","1","6",286,223,509
"2024",9085,"0","MACUL               ","GABRIELA MISTRAL","1","6",280,219,499
"2017",9090,"0","MACUL               ","GABRIELA MISTRAL","1","6",97,59,156
"2018",9090,"0","MACUL               ","GABRIELA MISTRAL","1","6",137,91,228
"2019",9090,"0","MACUL               ","GABRIELA MISTRAL","1","6",171,125,296
"2020",9090,"0","MACUL               ","GABRIELA MISTRAL","1","6",164,125,289
"2021",9090,"0","MACUL               ","GABRIELA MISTRAL","1","6",172,120,292
"2022",9090,"0","MACUL               ","GABRIELA MISTRAL","1","6",176,123,299
"2023",9090,"0","MACUL               ","GABRIELA MISTRAL","1","6",172,109,281
"2024",9090,"0","MACUL               ","GABRIELA MISTRAL","1","6",156,96,252
"2017",9104,"0","MACUL               ","GABRIELA MISTRAL","1","6",381,387,768
"2018",9104,"0","MACUL               ","GABRIELA MISTRAL","1","6",397,379,776
"2019",9104,"0","MACUL               ","GABRIELA MISTRAL","1","6",398,391,789
"2020",9104,"0","MACUL               ","GABRIELA MISTRAL","1","6",381,350,731
"2021",9104,"0","MACUL               ","GABRIELA MISTRAL","1","6",353,365,718
"2022",9104,"0","MACUL               ","GABRIELA MISTRAL","1","6",350,361,711
"2023",9104,"0","MACUL               ","GABRIELA MISTRAL","1","6",344,324,668
"2024",9104,"0","MACUL               ","GABRIELA MISTRAL","1","6",298,302,600
"2017",9116,"0","MACUL               ","GABRIELA MISTRAL","1","6",51,31,82
"2018",9116,"0","MACUL               ","GABRIELA MISTRAL","1","6",64,40,104
"2019",9116,"0","MACUL               ","GABRIELA MISTRAL","1","6",94,58,152
"2020",9116,"0","MACUL               ","GABRIELA MISTRAL","1","6",82,50,132
"2021",9116,"0","MACUL               ","GABRIELA MISTRAL","1","6",69,49,118
"2022",9116,"0","MACUL               ","GABRIELA MISTRAL","1","6",64,52,116
"2023",9116,"0","MACUL               ","GABRIELA MISTRAL","1","6",67,49,116
"2024",9116,"0","MACUL               ","GABRIELA MISTRAL","1","6",61,52,113
"2017",9122,"0","MACUL               ","GABRIELA MISTRAL","1","6",213,153,366
"2018",9122,"0","MACUL               ","GABRIELA MISTRAL","1","6",255,219,474
"2019",9122,"0","MACUL               ","GABRIELA MISTRAL","1","6",296,258,554
"2020",9122,"0","MACUL               ","GABRIELA MISTRAL","1","6",296,269,565
"2021",9122,"0","MACUL               ","GABRIELA MISTRAL","1","6",327,262,589
"2022",9122,"0","MACUL               ","GABRIELA MISTRAL","1","6",318,268,586
"2023",9122,"0","MACUL               ","GABRIELA MISTRAL","1","6",307,263,570
"2024",9122,"0","MACUL               ","GABRIELA MISTRAL","1","6",266,271,537
"2017",9125,"0","MACUL               ","GABRIELA MISTRAL","1","6",394,398,792
"2018",9125,"0","MACUL               ","GABRIELA MISTRAL","1","6",410,399,809
"2019",9125,"0","MACUL               ","GABRIELA MISTRAL","1","6",416,389,805
"2020",9125,"0","MACUL               ","GABRIELA MISTRAL","1","6",414,350,764
"2021",9125,"0","MACUL               ","GABRIELA MISTRAL","1","6",412,343,755
"2022",9125,"0","MACUL               ","GABRIELA MISTRAL","1","6",343,288,631
"2023",9125,"0","MACUL               ","GABRIELA MISTRAL","1","6",341,250,591
"2024",9125,"0","MACUL               ","GABRIELA MISTRAL","1","6",340,277,617
"2017",9411,"0","SAN JOAQUÍN        ","GABRIELA MISTRAL","1","6",458,400,858
"2018",9411,"0","SAN JOAQUÍN        ","GABRIELA MISTRAL","1","6",471,388,859
"2019",9411,"0","SAN JOAQUÍN        ","GABRIELA MISTRAL","1","6",491,353,844
"2020",9411,"0","SAN JOAQUÍN        ","GABRIELA MISTRAL","1","6",492,344,836
"2021",9411,"0","SAN JOAQUÍN        ","GABRIELA MISTRAL","1","6",506,390,896
"2022",9411,"0","SAN JOAQUÍN        ","GABRIELA MISTRAL","1","6",442,370,812
"2023",9411,"0","SAN JOAQUÍN        ","GABRIELA MISTRAL","1","6",398,344,742
"2024",9411,"0","SAN JOAQUÍN        ","GABRIELA MISTRAL","1","6",372,370,742
"2017",9414,"0","SAN JOAQUÍN        ","GABRIELA MISTRAL","1","6",253,223,476
"2018",9414,"0","SAN JOAQUÍN        ","GABRIELA MISTRAL","1","6",281,249,530
"2019",9414,"0","SAN JOAQUÍN        ","GABRIELA MISTRAL","1","6",313,287,600
"2020",9414,"0","SAN JOAQUÍN        ","GABRIELA MISTRAL","1","6",317,285,602
"2021",9414,"0","SAN JOAQUÍN        ","GABRIELA MISTRAL","1","6",329,281,610
"2022",9414,"0","SAN JOAQUÍN        ","GABRIELA MISTRAL","1","6",317,286,603
"2023",9414,"0","SAN JOAQUÍN        ","GABRIELA MISTRAL","1","6",325,262,587
"2024",9414,"0","SAN JOAQUÍN        ","GABRIELA MISTRAL","1","6",330,255,585
"2017",9421,"0","SAN JOAQUÍN        ","GABRIELA MISTRAL","1","6",128,103,231
"2018",9421,"0","SAN JOAQUÍN        ","GABRIELA MISTRAL","1","6",141,110,251
"2019",9421,"0","SAN JOAQUÍN        ","GABRIELA MISTRAL","1","6",172,132,304
"2020",9421,"0","SAN JOAQUÍN        ","GABRIELA MISTRAL","1","6",160,146,306
"2021",9421,"0","SAN JOAQUÍN        ","GABRIELA MISTRAL","1","6",164,144,308
"2022",9421,"0","SAN JOAQUÍN        ","GABRIELA MISTRAL","1","6",194,146,340
"2023",9421,"0","SAN JOAQUÍN        ","GABRIELA MISTRAL","1","6",180,142,322
"2024",9421,"0","SAN JOAQUÍN        ","GABRIELA MISTRAL","1","6",164,146,310
"2017",9424,"0","SAN JOAQUÍN        ","GABRIELA MISTRAL","1","6",369,300,669
"2018",9424,"0","SAN JOAQUÍN        ","GABRIELA MISTRAL","1","6",372,306,678
"2019",9424,"0","SAN JOAQUÍN        ","GABRIELA MISTRAL","1","6",374,323,697
"2020",9424,"0","SAN JOAQUÍN        ","GABRIELA MISTRAL","1","6",375,352,727
"2021",9424,"0","SAN JOAQUÍN        ","GABRIELA MISTRAL","1","6",346,335,681
"2022",9424,"0","SAN JOAQUÍN        ","GABRIELA MISTRAL","1","6",352,335,687
"2023",9424,"0","SAN JOAQUÍN        ","GABRIELA MISTRAL","1","6",368,315,683
"2024",9424,"0","SAN JOAQUÍN        ","GABRIELA MISTRAL","1","6",326,293,619
"2017",9429,"0","SAN JOAQUÍN        ","GABRIELA MISTRAL","1","6",170,126,296
"2018",9429,"0","SAN JOAQUÍN        ","GABRIELA MISTRAL","1","6",166,136,302
"2019",9429,"0","SAN JOAQUÍN        ","GABRIELA MISTRAL","1","6",188,133,321
"2020",9429,"0","SAN JOAQUÍN        ","GABRIELA MISTRAL","1","6",189,138,327
"2021",9429,"0","SAN JOAQUÍN        ","GABRIELA MISTRAL","1","6",155,152,307
"2022",9429,"0","SAN JOAQUÍN        ","GABRIELA MISTRAL","1","6",172,129,301
"2023",9429,"0","SAN JOAQUÍN        ","GABRIELA MISTRAL","1","6",169,127,296
"2024",9429,"0","SAN JOAQUÍN        ","GABRIELA MISTRAL","1","6",166,136,302
"2017",9430,"0","SAN JOAQUÍN        ","GABRIELA MISTRAL","1","6",198,188,386
"2018",9430,"0","SAN JOAQUÍN        ","GABRIELA MISTRAL","1","6",225,232,457
"2019",9430,"0","SAN JOAQUÍN        ","GABRIELA MISTRAL","1","6",296,285,581
"2020",9430,"0","SAN JOAQUÍN        ","GABRIELA MISTRAL","1","6",301,295,596
"2021",9430,"0","SAN JOAQUÍN        ","GABRIELA MISTRAL","1","6",301,295,596
"2022",9430,"0","SAN JOAQUÍN        ","GABRIELA MISTRAL","1","6",297,293,590
"2023",9430,"0","SAN JOAQUÍN        ","GABRIELA MISTRAL","1","6",286,297,583
"2024",9430,"0","SAN JOAQUÍN        ","GABRIELA MISTRAL","1","6",312,279,591
"2017",9437,"0","SAN JOAQUÍN        ","GABRIELA MISTRAL","1","6",100,78,178
"2018",9437,"0","SAN JOAQUÍN        ","GABRIELA MISTRAL","1","6",125,81,206
"2019",9437,"0","SAN JOAQUÍN        ","GABRIELA MISTRAL","1","6",226,93,319
"2020",9437,"0","SAN JOAQUÍN        ","GABRIELA MISTRAL","1","6",239,111,350
"2021",9437,"0","SAN JOAQUÍN        ","GABRIELA MISTRAL","1","6",236,101,337
"2022",9437,"0","SAN JOAQUÍN        ","GABRIELA MISTRAL","1","6",265,109,374
"2023",9437,"0","SAN JOAQUÍN        ","GABRIELA MISTRAL","1","6",255,113,368
"2024",9437,"0","SAN JOAQUÍN        ","GABRIELA MISTRAL","1","6",221,129,350
"2017",9443,"0","LA GRANJA           ","GABRIELA MISTRAL","1","6",135,98,233
"2018",9443,"0","LA GRANJA           ","GABRIELA MISTRAL","1","6",131,103,234
"2019",9443,"0","LA GRANJA           ","GABRIELA MISTRAL","1","6",123,88,211
"2020",9443,"0","LA GRANJA           ","GABRIELA MISTRAL","1","6",115,94,209
"2021",9443,"0","LA GRANJA           ","GABRIELA MISTRAL","1","6",112,90,202
"2022",9443,"0","LA GRANJA           ","GABRIELA MISTRAL","1","6",89,71,160
"2023",9443,"0","LA GRANJA           ","GABRIELA MISTRAL","1","6",73,59,132
"2024",9443,"0","LA GRANJA           ","GABRIELA MISTRAL","1","6",76,47,123
"2017",9457,"0","SAN JOAQUÍN        ","GABRIELA MISTRAL","1","6",143,95,238
"2018",9457,"0","SAN JOAQUÍN        ","GABRIELA MISTRAL","1","6",169,107,276
"2019",9457,"0","SAN JOAQUÍN        ","GABRIELA MISTRAL","1","6",175,132,307
"2020",9457,"0","SAN JOAQUÍN        ","GABRIELA MISTRAL","1","6",194,135,329
"2021",9457,"0","SAN JOAQUÍN        ","GABRIELA MISTRAL","1","6",180,142,322
"2022",9457,"0","SAN JOAQUÍN        ","GABRIELA MISTRAL","1","6",170,133,303
"2023",9457,"0","SAN JOAQUÍN        ","GABRIELA MISTRAL","1","6",184,143,327
"2024",9457,"0","SAN JOAQUÍN        ","GABRIELA MISTRAL","1","6",177,139,316
"2017",9582,"0","LA GRANJA           ","GABRIELA MISTRAL","1","6",113,83,196
"2018",9582,"0","LA GRANJA           ","GABRIELA MISTRAL","1","6",122,86,208
"2019",9582,"0","LA GRANJA           ","GABRIELA MISTRAL","1","6",140,92,232
"2020",9582,"0","LA GRANJA           ","GABRIELA MISTRAL","1","6",141,110,251
"2021",9582,"0","LA GRANJA           ","GABRIELA MISTRAL","1","6",146,111,257
"2022",9582,"0","LA GRANJA           ","GABRIELA MISTRAL","1","6",146,117,263
"2023",9582,"0","LA GRANJA           ","GABRIELA MISTRAL","1","6",156,132,288
"2024",9582,"0","LA GRANJA           ","GABRIELA MISTRAL","1","6",188,137,325
"2017",9585,"0","LA GRANJA           ","GABRIELA MISTRAL","1","6",143,146,289
"2018",9585,"0","LA GRANJA           ","GABRIELA MISTRAL","1","6",149,145,294
"2019",9585,"0","LA GRANJA           ","GABRIELA MISTRAL","1","6",129,152,281
"2020",9585,"0","LA GRANJA           ","GABRIELA MISTRAL","1","6",133,133,266
"2021",9585,"0","LA GRANJA           ","GABRIELA MISTRAL","1","6",111,134,245
"2022",9585,"0","LA GRANJA           ","GABRIELA MISTRAL","1","6",105,119,224
"2023",9585,"0","LA GRANJA           ","GABRIELA MISTRAL","1","6",123,130,253
"2024",9585,"0","LA GRANJA           ","GABRIELA MISTRAL","1","6",116,111,227
"2017",9587,"0","LA GRANJA           ","GABRIELA MISTRAL","1","6",363,337,700
"2018",9587,"0","LA GRANJA           ","GABRIELA MISTRAL","1","6",354,347,701
"2019",9587,"0","LA GRANJA           ","GABRIELA MISTRAL","1","6",383,316,699
"2020",9587,"0","LA GRANJA           ","GABRIELA MISTRAL","1","6",384,314,698
"2021",9587,"0","LA GRANJA           ","GABRIELA MISTRAL","1","6",366,335,701
"2022",9587,"0","LA GRANJA           ","GABRIELA MISTRAL","1","6",343,323,666
"2023",9587,"0","LA GRANJA           ","GABRIELA MISTRAL","1","6",378,309,687
"2024",9587,"0","LA GRANJA           ","GABRIELA MISTRAL","1","6",341,315,656
"2017",9588,"0","LA GRANJA           ","GABRIELA MISTRAL","1","6",141,122,263
"2018",9588,"0","LA GRANJA           ","GABRIELA MISTRAL","1","6",121,108,229
"2019",9588,"0","LA GRANJA           ","GABRIELA MISTRAL","1","6",126,109,235
"2020",9588,"0","LA GRANJA           ","GABRIELA MISTRAL","1","6",117,119,236
"2021",9588,"0","LA GRANJA           ","GABRIELA MISTRAL","1","6",108,122,230
"2022",9588,"0","LA GRANJA           ","GABRIELA MISTRAL","1","6",102,115,217
"2023",9588,"0","LA GRANJA           ","GABRIELA MISTRAL","1","6",124,107,231
"2024",9588,"0","LA GRANJA           ","GABRIELA MISTRAL","1","6",122,111,233
"2017",9590,"0","LA GRANJA           ","GABRIELA MISTRAL","1","6",103,71,174
"2018",9590,"0","LA GRANJA           ","GABRIELA MISTRAL","1","6",95,83,178
"2019",9590,"0","LA GRANJA           ","GABRIELA MISTRAL","1","6",92,84,176
"2020",9590,"0","LA GRANJA           ","GABRIELA MISTRAL","1","6",106,94,200
"2021",9590,"0","LA GRANJA           ","GABRIELA MISTRAL","1","6",100,96,196
"2022",9590,"0","LA GRANJA           ","GABRIELA MISTRAL","1","6",93,88,181
"2023",9590,"0","LA GRANJA           ","GABRIELA MISTRAL","1","6",96,91,187
"2024",9590,"0","LA GRANJA           ","GABRIELA MISTRAL","1","6",107,84,191
"2017",9605,"0","LA GRANJA           ","GABRIELA MISTRAL","1","6",125,98,223
"2018",9605,"0","LA GRANJA           ","GABRIELA MISTRAL","1","6",137,111,248
"2019",9605,"0","LA GRANJA           ","GABRIELA MISTRAL","1","6",142,130,272
"2020",9605,"0","LA GRANJA           ","GABRIELA MISTRAL","1","6",129,120,249
"2021",9605,"0","LA GRANJA           ","GABRIELA MISTRAL","1","6",141,124,265
"2022",9605,"0","LA GRANJA           ","GABRIELA MISTRAL","1","6",150,125,275
"2023",9605,"0","LA GRANJA           ","GABRIELA MISTRAL","1","6",145,113,258
"2024",9605,"0","LA GRANJA           ","GABRIELA MISTRAL","1","6",144,121,265
"2017",9606,"0","LA GRANJA           ","GABRIELA MISTRAL","1","6",120,99,219
"2018",9606,"0","LA GRANJA           ","GABRIELA MISTRAL","1","6",149,94,243
"2019",9606,"0","LA GRANJA           ","GABRIELA MISTRAL","1","6",144,92,236
"2020",9606,"0","LA GRANJA           ","GABRIELA MISTRAL","1","6",144,105,249
"2021",9606,"0","LA GRANJA           ","GABRIELA MISTRAL","1","6",150,99,249
"2022",9606,"0","LA GRANJA           ","GABRIELA MISTRAL","1","6",142,108,250
"2023",9606,"0","LA GRANJA           ","GABRIELA MISTRAL","1","6",139,113,252
"2024",9606,"0","LA GRANJA           ","GABRIELA MISTRAL","1","6",136,114,250
"2017",9607,"0","LA GRANJA           ","GABRIELA MISTRAL","1","6",38,26,64
"2018",9607,"0","LA GRANJA           ","GABRIELA MISTRAL","1","6",34,32,66
"2019",9607,"0","LA GRANJA           ","GABRIELA MISTRAL","1","6",38,22,60
"2020",9607,"0","LA GRANJA           ","GABRIELA MISTRAL","1","6",32,14,46
"2021",9607,"0","LA GRANJA           ","GABRIELA MISTRAL","1","6",26,9,35
"2022",9607,"0","LA GRANJA           ","GABRIELA MISTRAL","1","6",30,8,38
"2023",9607,"0","LA GRANJA           ","GABRIELA MISTRAL","1","6",29,13,42
"2024",9607,"0","LA GRANJA           ","GABRIELA MISTRAL","1","6",25,7,32
"2017",9609,"0","LA GRANJA           ","GABRIELA MISTRAL","1","6",160,153,313
"2018",9609,"0","LA GRANJA           ","GABRIELA MISTRAL","1","6",164,149,313
"2019",9609,"0","LA GRANJA           ","GABRIELA MISTRAL","1","6",176,157,333
"2020",9609,"0","LA GRANJA           ","GABRIELA MISTRAL","1","6",164,149,313
"2021",9609,"0","LA GRANJA           ","GABRIELA MISTRAL","1","6",151,143,294
"2022",9609,"0","LA GRANJA           ","GABRIELA MISTRAL","1","6",165,132,297
"2023",9609,"0","LA GRANJA           ","GABRIELA MISTRAL","1","6",157,122,279
"2024",9609,"0","LA GRANJA           ","GABRIELA MISTRAL","1","6",155,120,275
"2017",9610,"0","LA GRANJA           ","GABRIELA MISTRAL","1","6",223,211,434
"2018",9610,"0","LA GRANJA           ","GABRIELA MISTRAL","1","6",229,200,429
"2019",9610,"0","LA GRANJA           ","GABRIELA MISTRAL","1","6",223,220,443
"2020",9610,"0","LA GRANJA           ","GABRIELA MISTRAL","1","6",212,215,427
"2021",9610,"0","LA GRANJA           ","GABRIELA MISTRAL","1","6",209,187,396
"2022",9610,"0","LA GRANJA           ","GABRIELA MISTRAL","1","6",223,186,409
"2023",9610,"0","LA GRANJA           ","GABRIELA MISTRAL","1","6",223,199,422
"2024",9610,"0","LA GRANJA           ","GABRIELA MISTRAL","1","6",215,176,391
"2017",9612,"0","LA GRANJA           ","GABRIELA MISTRAL","1","6",158,145,303
"2018",9612,"0","LA GRANJA           ","GABRIELA MISTRAL","1","6",156,163,319
"2019",9612,"0","LA GRANJA           ","GABRIELA MISTRAL","1","6",174,155,329
"2020",9612,"0","LA GRANJA           ","GABRIELA MISTRAL","1","6",160,143,303
"2021",9612,"0","LA GRANJA           ","GABRIELA MISTRAL","1","6",153,144,297
"2022",9612,"0","LA GRANJA           ","GABRIELA MISTRAL","1","6",153,136,289
"2023",9612,"0","LA GRANJA           ","GABRIELA MISTRAL","1","6",144,136,280
"2024",9612,"0","LA GRANJA           ","GABRIELA MISTRAL","1","6",129,137,266
"2017",9617,"0","LA GRANJA           ","GABRIELA MISTRAL","1","6",417,345,762
"2018",9617,"0","LA GRANJA           ","GABRIELA MISTRAL","1","6",431,352,783
"2019",9617,"0","LA GRANJA           ","GABRIELA MISTRAL","1","6",415,343,758
"2020",9617,"0","LA GRANJA           ","GABRIELA MISTRAL","1","6",378,306,684
"2021",9617,"0","LA GRANJA           ","GABRIELA MISTRAL","1","6",341,312,653
"2022",9617,"0","LA GRANJA           ","GABRIELA MISTRAL","1","6",313,266,579
"2023",9617,"0","LA GRANJA           ","GABRIELA MISTRAL","1","6",274,225,499
"2024",9617,"0","LA GRANJA           ","GABRIELA MISTRAL","1","6",229,208,437
"2017",9618,"0","LA GRANJA           ","GABRIELA MISTRAL","1","6",554,481,1035
"2018",9618,"0","LA GRANJA           ","GABRIELA MISTRAL","1","6",531,467,998
"2019",9618,"0","LA GRANJA           ","GABRIELA MISTRAL","1","6",512,474,986
"2020",9618,"0","LA GRANJA           ","GABRIELA MISTRAL","1","6",470,439,909
"2021",9618,"0","LA GRANJA           ","GABRIELA MISTRAL","1","6",439,405,844
"2022",9618,"0","LA GRANJA           ","GABRIELA MISTRAL","1","6",419,381,800
"2023",9618,"0","LA GRANJA           ","GABRIELA MISTRAL","1","6",382,340,722
"2024",9618,"0","LA GRANJA           ","GABRIELA MISTRAL","1","6",296,284,580
"2017",9626,"0","LA GRANJA           ","GABRIELA MISTRAL","1","6",26,17,43
"2018",9626,"0","LA GRANJA           ","GABRIELA MISTRAL","1","6",27,17,44
"2019",9626,"0","LA GRANJA           ","GABRIELA MISTRAL","1","6",24,21,45
"2020",9626,"0","LA GRANJA           ","GABRIELA MISTRAL","1","6",31,16,47
"2021",9626,"0","LA GRANJA           ","GABRIELA MISTRAL","1","6",29,17,46
"2022",9626,"0","LA GRANJA           ","GABRIELA MISTRAL","1","6",31,16,47
"2023",9626,"0","LA GRANJA           ","GABRIELA MISTRAL","1","6",27,17,44
"2024",9626,"0","LA GRANJA           ","GABRIELA MISTRAL","1","6",34,14,48
"2017",10010,"0","LO PRADO            ","BARRANCAS","1","3",135,118,253
"2018",10010,"0","LO PRADO            ","BARRANCAS","1","3",138,120,258
"2019",10010,"0","LO PRADO            ","BARRANCAS","1","3",161,142,303
"2020",10010,"0","LO PRADO            ","BARRANCAS","1","3",174,151,325
"2021",10010,"0","LO PRADO            ","BARRANCAS","1","3",149,137,286
"2022",10010,"0","LO PRADO            ","BARRANCAS","1","3",177,137,314
"2023",10010,"0","LO PRADO            ","BARRANCAS","1","3",165,157,322
"2024",10010,"0","LO PRADO            ","BARRANCAS","1","3",169,165,334
"2017",10074,"0","CERRO NAVIA         ","BARRANCAS","1","3",104,106,210
"2018",10074,"0","CERRO NAVIA         ","BARRANCAS","1","3",103,110,213
"2019",10074,"0","CERRO NAVIA         ","BARRANCAS","1","3",91,109,200
"2020",10074,"0","CERRO NAVIA         ","BARRANCAS","1","3",104,91,195
"2021",10074,"0","CERRO NAVIA         ","BARRANCAS","1","3",96,80,176
"2022",10074,"0","CERRO NAVIA         ","BARRANCAS","1","3",114,98,212
"2023",10074,"0","CERRO NAVIA         ","BARRANCAS","1","3",114,90,204
"2024",10074,"0","CERRO NAVIA         ","BARRANCAS","1","3",117,89,206
"2017",10075,"0","CERRO NAVIA         ","BARRANCAS","1","3",178,229,407
"2018",10075,"0","CERRO NAVIA         ","BARRANCAS","1","3",155,227,382
"2019",10075,"0","CERRO NAVIA         ","BARRANCAS","1","3",195,233,428
"2020",10075,"0","CERRO NAVIA         ","BARRANCAS","1","3",192,202,394
"2021",10075,"0","CERRO NAVIA         ","BARRANCAS","1","3",164,207,371
"2022",10075,"0","CERRO NAVIA         ","BARRANCAS","1","3",135,190,325
"2023",10075,"0","CERRO NAVIA         ","BARRANCAS","1","3",167,204,371
"2024",10075,"0","CERRO NAVIA         ","BARRANCAS","1","3",185,238,423
"2017",10076,"0","LO PRADO            ","BARRANCAS","1","3",407,464,871
"2018",10076,"0","LO PRADO            ","BARRANCAS","1","3",393,453,846
"2019",10076,"0","LO PRADO            ","BARRANCAS","1","3",390,446,836
"2020",10076,"0","LO PRADO            ","BARRANCAS","1","3",371,446,817
"2021",10076,"0","LO PRADO            ","BARRANCAS","1","3",411,471,882
"2022",10076,"0","LO PRADO            ","BARRANCAS","1","3",452,498,950
"2023",10076,"0","LO PRADO            ","BARRANCAS","1","3",447,510,957
"2024",10076,"0","LO PRADO            ","BARRANCAS","1","3",435,495,930
"2017",10077,"0","PUDAHUEL            ","BARRANCAS","1","3",260,153,413
"2018",10077,"0","PUDAHUEL            ","BARRANCAS","1","3",266,174,440
"2019",10077,"0","PUDAHUEL            ","BARRANCAS","1","3",220,190,410
"2020",10077,"0","PUDAHUEL            ","BARRANCAS","1","3",208,179,387
"2021",10077,"0","PUDAHUEL            ","BARRANCAS","1","3",219,200,419
"2022",10077,"0","PUDAHUEL            ","BARRANCAS","1","3",234,209,443
"2023",10077,"0","PUDAHUEL            ","BARRANCAS","1","3",269,197,466
"2024",10077,"0","PUDAHUEL            ","BARRANCAS","1","3",230,181,411
"2017",10080,"0","PUDAHUEL            ","BARRANCAS","1","3",178,204,382
"2018",10080,"0","PUDAHUEL            ","BARRANCAS","1","3",180,202,382
"2019",10080,"0","PUDAHUEL            ","BARRANCAS","1","3",203,210,413
"2020",10080,"0","PUDAHUEL            ","BARRANCAS","1","3",195,207,402
"2021",10080,"0","PUDAHUEL            ","BARRANCAS","1","3",187,184,371
"2022",10080,"0","PUDAHUEL            ","BARRANCAS","1","3",198,180,378
"2023",10080,"0","PUDAHUEL            ","BARRANCAS","1","3",188,177,365
"2024",10080,"0","PUDAHUEL            ","BARRANCAS","1","3",167,177,344
"2017",10081,"0","PUDAHUEL            ","BARRANCAS","1","3",681,578,1259
"2018",10081,"0","PUDAHUEL            ","BARRANCAS","1","3",698,558,1256
"2019",10081,"0","PUDAHUEL            ","BARRANCAS","1","3",681,547,1228
"2020",10081,"0","PUDAHUEL            ","BARRANCAS","1","3",676,508,1184
"2021",10081,"0","PUDAHUEL            ","BARRANCAS","1","3",682,504,1186
"2022",10081,"0","PUDAHUEL            ","BARRANCAS","1","3",694,491,1185
"2023",10081,"0","PUDAHUEL            ","BARRANCAS","1","3",619,472,1091
"2024",10081,"0","PUDAHUEL            ","BARRANCAS","1","3",585,416,1001
"2017",10083,"0","CERRO NAVIA         ","BARRANCAS","1","3",253,256,509
"2018",10083,"0","CERRO NAVIA         ","BARRANCAS","1","3",265,234,499
"2019",10083,"0","CERRO NAVIA         ","BARRANCAS","1","3",260,218,478
"2020",10083,"0","CERRO NAVIA         ","BARRANCAS","1","3",268,206,474
"2021",10083,"0","CERRO NAVIA         ","BARRANCAS","1","3",247,189,436
"2022",10083,"0","CERRO NAVIA         ","BARRANCAS","1","3",264,219,483
"2023",10083,"0","CERRO NAVIA         ","BARRANCAS","1","3",249,200,449
"2024",10083,"0","CERRO NAVIA         ","BARRANCAS","1","3",214,174,388
"2017",10085,"0","PUDAHUEL            ","BARRANCAS","1","3",374,301,675
"2018",10085,"0","PUDAHUEL            ","BARRANCAS","1","3",377,289,666
"2019",10085,"0","PUDAHUEL            ","BARRANCAS","1","3",373,289,662
"2020",10085,"0","PUDAHUEL            ","BARRANCAS","1","3",367,279,646
"2021",10085,"0","PUDAHUEL            ","BARRANCAS","1","3",346,274,620
"2022",10085,"0","PUDAHUEL            ","BARRANCAS","1","3",356,279,635
"2023",10085,"0","PUDAHUEL            ","BARRANCAS","1","3",351,279,630
"2024",10085,"0","PUDAHUEL            ","BARRANCAS","1","3",333,258,591
"2017",10086,"0","CERRO NAVIA         ","BARRANCAS","1","3",177,123,300
"2018",10086,"0","CERRO NAVIA         ","BARRANCAS","1","3",163,120,283
"2019",10086,"0","CERRO NAVIA         ","BARRANCAS","1","3",164,134,298
"2020",10086,"0","CERRO NAVIA         ","BARRANCAS","1","3",149,140,289
"2021",10086,"0","CERRO NAVIA         ","BARRANCAS","1","3",145,115,260
"2022",10086,"0","CERRO NAVIA         ","BARRANCAS","1","3",146,119,265
"2023",10086,"0","CERRO NAVIA         ","BARRANCAS","1","3",144,115,259
"2024",10086,"0","CERRO NAVIA         ","BARRANCAS","1","3",133,106,239
"2017",10087,"0","CERRO NAVIA         ","BARRANCAS","1","3",161,121,282
"2018",10087,"0","CERRO NAVIA         ","BARRANCAS","1","3",143,107,250
"2019",10087,"0","CERRO NAVIA         ","BARRANCAS","1","3",163,102,265
"2020",10087,"0","CERRO NAVIA         ","BARRANCAS","1","3",175,127,302
"2021",10087,"0","CERRO NAVIA         ","BARRANCAS","1","3",158,110,268
"2022",10087,"0","CERRO NAVIA         ","BARRANCAS","1","3",152,126,278
"2023",10087,"0","CERRO NAVIA         ","BARRANCAS","1","3",147,125,272
"2024",10087,"0","CERRO NAVIA         ","BARRANCAS","1","3",282,233,515
"2017",10088,"0","CERRO NAVIA         ","BARRANCAS","1","3",130,104,234
"2018",10088,"0","CERRO NAVIA         ","BARRANCAS","1","3",135,96,231
"2019",10088,"0","CERRO NAVIA         ","BARRANCAS","1","3",134,119,253
"2020",10088,"0","CERRO NAVIA         ","BARRANCAS","1","3",106,101,207
"2021",10088,"0","CERRO NAVIA         ","BARRANCAS","1","3",104,104,208
"2022",10088,"0","CERRO NAVIA         ","BARRANCAS","1","3",124,128,252
"2023",10088,"0","CERRO NAVIA         ","BARRANCAS","1","3",128,122,250
"2024",10088,"0","CERRO NAVIA         ","BARRANCAS","1","3",117,112,229
"2017",10089,"0","LO PRADO            ","BARRANCAS","1","3",255,240,495
"2018",10089,"0","LO PRADO            ","BARRANCAS","1","3",288,241,529
"2019",10089,"0","LO PRADO            ","BARRANCAS","1","3",293,225,518
"2020",10089,"0","LO PRADO            ","BARRANCAS","1","3",322,246,568
"2021",10089,"0","LO PRADO            ","BARRANCAS","1","3",311,247,558
"2022",10089,"0","LO PRADO            ","BARRANCAS","1","3",352,228,580
"2023",10089,"0","LO PRADO            ","BARRANCAS","1","3",328,265,593
"2024",10089,"0","LO PRADO            ","BARRANCAS","1","3",295,255,550
"2017",10090,"0","PUDAHUEL            ","BARRANCAS","1","3",309,254,563
"2018",10090,"0","PUDAHUEL            ","BARRANCAS","1","3",317,266,583
"2019",10090,"0","PUDAHUEL            ","BARRANCAS","1","3",297,245,542
"2020",10090,"0","PUDAHUEL            ","BARRANCAS","1","3",289,229,518
"2021",10090,"0","PUDAHUEL            ","BARRANCAS","1","3",282,219,501
"2022",10090,"0","PUDAHUEL            ","BARRANCAS","1","3",254,228,482
"2023",10090,"0","PUDAHUEL            ","BARRANCAS","1","3",264,206,470
"2024",10090,"0","PUDAHUEL            ","BARRANCAS","1","3",240,206,446
"2017",10091,"0","LO PRADO            ","BARRANCAS","1","3",292,218,510
"2018",10091,"0","LO PRADO            ","BARRANCAS","1","3",286,206,492
"2019",10091,"0","LO PRADO            ","BARRANCAS","1","3",322,240,562
"2020",10091,"0","LO PRADO            ","BARRANCAS","1","3",325,250,575
"2021",10091,"0","LO PRADO            ","BARRANCAS","1","3",330,225,555
"2022",10091,"0","LO PRADO            ","BARRANCAS","1","3",320,252,572
"2023",10091,"0","LO PRADO            ","BARRANCAS","1","3",279,259,538
"2024",10091,"0","LO PRADO            ","BARRANCAS","1","3",297,239,536
"2017",10092,"0","LO PRADO            ","BARRANCAS","1","3",164,99,263
"2018",10092,"0","LO PRADO            ","BARRANCAS","1","3",183,109,292
"2019",10092,"0","LO PRADO            ","BARRANCAS","1","3",207,121,328
"2020",10092,"0","LO PRADO            ","BARRANCAS","1","3",215,139,354
"2021",10092,"0","LO PRADO            ","BARRANCAS","1","3",191,127,318
"2022",10092,"0","LO PRADO            ","BARRANCAS","1","3",225,126,351
"2023",10092,"0","LO PRADO            ","BARRANCAS","1","3",183,152,335
"2024",10092,"0","LO PRADO            ","BARRANCAS","1","3",172,150,322
"2017",10093,"0","CERRO NAVIA         ","BARRANCAS","1","3",161,138,299
"2018",10093,"0","CERRO NAVIA         ","BARRANCAS","1","3",194,137,331
"2019",10093,"0","CERRO NAVIA         ","BARRANCAS","1","3",166,122,288
"2020",10093,"0","CERRO NAVIA         ","BARRANCAS","1","3",173,119,292
"2021",10093,"0","CERRO NAVIA         ","BARRANCAS","1","3",164,115,279
"2022",10093,"0","CERRO NAVIA         ","BARRANCAS","1","3",189,104,293
"2023",10093,"0","CERRO NAVIA         ","BARRANCAS","1","3",155,80,235
"2024",10093,"0","CERRO NAVIA         ","BARRANCAS","1","3",134,78,212
"2017",10095,"0","LO PRADO            ","BARRANCAS","1","3",91,48,139
"2018",10095,"0","LO PRADO            ","BARRANCAS","1","3",111,59,170
"2019",10095,"0","LO PRADO            ","BARRANCAS","1","3",116,68,184
"2020",10095,"0","LO PRADO            ","BARRANCAS","1","3",116,74,190
"2021",10095,"0","LO PRADO            ","BARRANCAS","1","3",115,71,186
"2022",10095,"0","LO PRADO            ","BARRANCAS","1","3",109,76,185
"2023",10095,"0","LO PRADO            ","BARRANCAS","1","3",119,63,182
"2024",10095,"0","LO PRADO            ","BARRANCAS","1","3",116,73,189
"2017",10097,"0","LO PRADO            ","BARRANCAS","1","3",99,86,185
"2018",10097,"0","LO PRADO            ","BARRANCAS","1","3",112,82,194
"2019",10097,"0","LO PRADO            ","BARRANCAS","1","3",115,90,205
"2020",10097,"0","LO PRADO            ","BARRANCAS","1","3",103,91,194
"2021",10097,"0","LO PRADO            ","BARRANCAS","1","3",113,83,196
"2022",10097,"0","LO PRADO            ","BARRANCAS","1","3",110,102,212
"2023",10097,"0","LO PRADO            ","BARRANCAS","1","3",124,100,224
"2024",10097,"0","LO PRADO            ","BARRANCAS","1","3",132,88,220
"2017",10098,"0","CERRO NAVIA         ","BARRANCAS","1","3",111,108,219
"2018",10098,"0","CERRO NAVIA         ","BARRANCAS","1","3",112,126,238
"2019",10098,"0","CERRO NAVIA         ","BARRANCAS","1","3",120,134,254
"2020",10098,"0","CERRO NAVIA         ","BARRANCAS","1","3",143,123,266
"2021",10098,"0","CERRO NAVIA         ","BARRANCAS","1","3",131,119,250
"2022",10098,"0","CERRO NAVIA         ","BARRANCAS","1","3",137,122,259
"2023",10098,"0","CERRO NAVIA         ","BARRANCAS","1","3",136,125,261
"2024",10098,"0","CERRO NAVIA         ","BARRANCAS","1","3",121,114,235
"2017",10099,"0","CERRO NAVIA         ","BARRANCAS","1","3",153,145,298
"2018",10099,"0","CERRO NAVIA         ","BARRANCAS","1","3",150,171,321
"2019",10099,"0","CERRO NAVIA         ","BARRANCAS","1","3",136,160,296
"2020",10099,"0","CERRO NAVIA         ","BARRANCAS","1","3",145,158,303
"2021",10099,"0","CERRO NAVIA         ","BARRANCAS","1","3",152,138,290
"2022",10099,"0","CERRO NAVIA         ","BARRANCAS","1","3",146,145,291
"2023",10099,"0","CERRO NAVIA         ","BARRANCAS","1","3",145,153,298
"2024",10099,"0","CERRO NAVIA         ","BARRANCAS","1","3",152,138,290
"2017",10100,"0","PUDAHUEL            ","BARRANCAS","1","3",156,140,296
"2018",10100,"0","PUDAHUEL            ","BARRANCAS","1","3",161,115,276
"2019",10100,"0","PUDAHUEL            ","BARRANCAS","1","3",167,125,292
"2020",10100,"0","PUDAHUEL            ","BARRANCAS","1","3",155,125,280
"2021",10100,"0","PUDAHUEL            ","BARRANCAS","1","3",140,117,257
"2022",10100,"0","PUDAHUEL            ","BARRANCAS","1","3",139,121,260
"2023",10100,"0","PUDAHUEL            ","BARRANCAS","1","3",122,105,227
"2024",10100,"0","PUDAHUEL            ","BARRANCAS","1","3",140,117,257
"2017",10102,"0","PUDAHUEL            ","BARRANCAS","1","3",129,90,219
"2018",10102,"0","PUDAHUEL            ","BARRANCAS","1","3",135,97,232
"2019",10102,"0","PUDAHUEL            ","BARRANCAS","1","3",123,90,213
"2020",10102,"0","PUDAHUEL            ","BARRANCAS","1","3",135,89,224
"2021",10102,"0","PUDAHUEL            ","BARRANCAS","1","3",115,80,195
"2022",10102,"0","PUDAHUEL            ","BARRANCAS","1","3",118,80,198
"2023",10102,"0","PUDAHUEL            ","BARRANCAS","1","3",129,100,229
"2024",10102,"0","PUDAHUEL            ","BARRANCAS","1","3",109,83,192
"2017",10103,"0","LO PRADO            ","BARRANCAS","1","3",338,313,651
"2018",10103,"0","LO PRADO            ","BARRANCAS","1","3",350,290,640
"2019",10103,"0","LO PRADO            ","BARRANCAS","1","3",337,275,612
"2020",10103,"0","LO PRADO            ","BARRANCAS","1","3",315,260,575
"2021",10103,"0","LO PRADO            ","BARRANCAS","1","3",314,253,567
"2022",10103,"0","LO PRADO            ","BARRANCAS","1","3",311,259,570
"2023",10103,"0","LO PRADO            ","BARRANCAS","1","3",324,259,583
"2024",10103,"0","LO PRADO            ","BARRANCAS","1","3",304,229,533
"2017",10104,"0","PUDAHUEL            ","BARRANCAS","1","3",186,188,374
"2018",10104,"0","PUDAHUEL            ","BARRANCAS","1","3",179,188,367
"2019",10104,"0","PUDAHUEL            ","BARRANCAS","1","3",167,199,366
"2020",10104,"0","PUDAHUEL            ","BARRANCAS","1","3",168,196,364
"2021",10104,"0","PUDAHUEL            ","BARRANCAS","1","3",155,166,321
"2022",10104,"0","PUDAHUEL            ","BARRANCAS","1","3",146,159,305
"2023",10104,"0","PUDAHUEL            ","BARRANCAS","1","3",156,146,302
"2024",10104,"0","PUDAHUEL            ","BARRANCAS","1","3",179,139,318
"2017",10105,"0","CERRO NAVIA         ","BARRANCAS","1","3",336,305,641
"2018",10105,"0","CERRO NAVIA         ","BARRANCAS","1","3",318,279,597
"2019",10105,"0","CERRO NAVIA         ","BARRANCAS","1","3",281,252,533
"2020",10105,"0","CERRO NAVIA         ","BARRANCAS","1","3",299,227,526
"2021",10105,"0","CERRO NAVIA         ","BARRANCAS","1","3",291,239,530
"2022",10105,"0","CERRO NAVIA         ","BARRANCAS","1","3",283,242,525
"2023",10105,"0","CERRO NAVIA         ","BARRANCAS","1","3",267,246,513
"2024",10105,"0","CERRO NAVIA         ","BARRANCAS","1","3",277,235,512
"2017",10106,"0","LO PRADO            ","BARRANCAS","1","3",277,245,522
"2018",10106,"0","LO PRADO            ","BARRANCAS","1","3",295,250,545
"2019",10106,"0","LO PRADO            ","BARRANCAS","1","3",392,322,714
"2020",10106,"0","LO PRADO            ","BARRANCAS","1","3",417,333,750
"2021",10106,"0","LO PRADO            ","BARRANCAS","1","3",383,341,724
"2022",10106,"0","LO PRADO            ","BARRANCAS","1","3",449,358,807
"2023",10106,"0","LO PRADO            ","BARRANCAS","1","3",447,355,802
"2024",10106,"0","LO PRADO            ","BARRANCAS","1","3",465,378,843
"2017",10107,"0","CERRO NAVIA         ","BARRANCAS","1","3",92,116,208
"2018",10107,"0","CERRO NAVIA         ","BARRANCAS","1","3",109,120,229
"2019",10107,"0","CERRO NAVIA         ","BARRANCAS","1","3",109,129,238
"2020",10107,"0","CERRO NAVIA         ","BARRANCAS","1","3",121,141,262
"2021",10107,"0","CERRO NAVIA         ","BARRANCAS","1","3",147,114,261
"2022",10107,"0","CERRO NAVIA         ","BARRANCAS","1","3",149,122,271
"2023",10107,"0","CERRO NAVIA         ","BARRANCAS","1","3",138,120,258
"2024",10107,"0","CERRO NAVIA         ","BARRANCAS","1","3",144,110,254
"2017",10108,"0","CERRO NAVIA         ","BARRANCAS","1","3",138,125,263
"2018",10108,"0","CERRO NAVIA         ","BARRANCAS","1","3",133,137,270
"2019",10108,"0","CERRO NAVIA         ","BARRANCAS","1","3",148,144,292
"2020",10108,"0","CERRO NAVIA         ","BARRANCAS","1","3",132,136,268
"2021",10108,"0","CERRO NAVIA         ","BARRANCAS","1","3",128,119,247
"2022",10108,"0","CERRO NAVIA         ","BARRANCAS","1","3",140,119,259
"2023",10108,"0","CERRO NAVIA         ","BARRANCAS","1","3",135,121,256
"2024",10108,"0","CERRO NAVIA         ","BARRANCAS","1","3",131,117,248
"2017",10109,"0","CERRO NAVIA         ","BARRANCAS","1","3",113,99,212
"2018",10109,"0","CERRO NAVIA         ","BARRANCAS","1","3",121,93,214
"2019",10109,"0","CERRO NAVIA         ","BARRANCAS","1","3",127,101,228
"2020",10109,"0","CERRO NAVIA         ","BARRANCAS","1","3",126,99,225
"2021",10109,"0","CERRO NAVIA         ","BARRANCAS","1","3",128,110,238
"2022",10109,"0","CERRO NAVIA         ","BARRANCAS","1","3",127,123,250
"2023",10109,"0","CERRO NAVIA         ","BARRANCAS","1","3",119,105,224
"2024",10109,"0","CERRO NAVIA         ","BARRANCAS","1","3",118,109,227
"2017",10113,"0","PUDAHUEL            ","BARRANCAS","1","3",258,252,510
"2018",10113,"0","PUDAHUEL            ","BARRANCAS","1","3",251,251,502
"2019",10113,"0","PUDAHUEL            ","BARRANCAS","1","3",262,245,507
"2020",10113,"0","PUDAHUEL            ","BARRANCAS","1","3",259,235,494
"2021",10113,"0","PUDAHUEL            ","BARRANCAS","1","3",236,218,454
"2022",10113,"0","PUDAHUEL            ","BARRANCAS","1","3",249,218,467
"2023",10113,"0","PUDAHUEL            ","BARRANCAS","1","3",249,211,460
"2024",10113,"0","PUDAHUEL            ","BARRANCAS","1","3",241,212,453
"2017",10114,"0","LO PRADO            ","BARRANCAS","1","3",247,210,457
"2018",10114,"0","LO PRADO            ","BARRANCAS","1","3",240,208,448
"2019",10114,"0","LO PRADO            ","BARRANCAS","1","3",260,212,472
"2020",10114,"0","LO PRADO            ","BARRANCAS","1","3",263,212,475
"2021",10114,"0","LO PRADO            ","BARRANCAS","1","3",237,205,442
"2022",10114,"0","LO PRADO            ","BARRANCAS","1","3",209,190,399
"2023",10114,"0","LO PRADO            ","BARRANCAS","1","3",250,188,438
"2024",10114,"0","LO PRADO            ","BARRANCAS","1","3",230,178,408
"2017",10116,"0","CERRO NAVIA         ","BARRANCAS","1","3",218,189,407
"2018",10116,"0","CERRO NAVIA         ","BARRANCAS","1","3",251,188,439
"2019",10116,"0","CERRO NAVIA         ","BARRANCAS","1","3",258,197,455
"2020",10116,"0","CERRO NAVIA         ","BARRANCAS","1","3",244,215,459
"2021",10116,"0","CERRO NAVIA         ","BARRANCAS","1","3",235,208,443
"2022",10116,"0","CERRO NAVIA         ","BARRANCAS","1","3",235,224,459
"2023",10116,"0","CERRO NAVIA         ","BARRANCAS","1","3",241,221,462
"2024",10116,"0","CERRO NAVIA         ","BARRANCAS","1","3",224,212,436
"2017",10117,"0","CERRO NAVIA         ","BARRANCAS","1","3",146,130,276
"2018",10117,"0","CERRO NAVIA         ","BARRANCAS","1","3",140,121,261
"2019",10117,"0","CERRO NAVIA         ","BARRANCAS","1","3",158,116,274
"2020",10117,"0","CERRO NAVIA         ","BARRANCAS","1","3",169,108,277
"2021",10117,"0","CERRO NAVIA         ","BARRANCAS","1","3",147,128,275
"2022",10117,"0","CERRO NAVIA         ","BARRANCAS","1","3",149,122,271
"2023",10117,"0","CERRO NAVIA         ","BARRANCAS","1","3",165,128,293
"2024",10117,"0","CERRO NAVIA         ","BARRANCAS","1","3",159,132,291
"2017",10119,"0","LO PRADO            ","BARRANCAS","1","3",239,180,419
"2018",10119,"0","LO PRADO            ","BARRANCAS","1","3",246,194,440
"2019",10119,"0","LO PRADO            ","BARRANCAS","1","3",283,215,498
"2020",10119,"0","LO PRADO            ","BARRANCAS","1","3",244,212,456
"2021",10119,"0","LO PRADO            ","BARRANCAS","1","3",215,201,416
"2022",10119,"0","LO PRADO            ","BARRANCAS","1","3",217,216,433
"2023",10119,"0","LO PRADO            ","BARRANCAS","1","3",228,198,426
"2024",10119,"0","LO PRADO            ","BARRANCAS","1","3",202,180,382
"2017",10120,"0","PUDAHUEL            ","BARRANCAS","1","3",239,340,579
"2018",10120,"0","PUDAHUEL            ","BARRANCAS","1","3",271,362,633
"2019",10120,"0","PUDAHUEL            ","BARRANCAS","1","3",226,310,536
"2020",10120,"0","PUDAHUEL            ","BARRANCAS","1","3",246,303,549
"2021",10120,"0","PUDAHUEL            ","BARRANCAS","1","3",182,244,426
"2022",10120,"0","PUDAHUEL            ","BARRANCAS","1","3",140,175,315
"2023",10120,"0","PUDAHUEL            ","BARRANCAS","1","3",167,190,357
"2024",10120,"0","PUDAHUEL            ","BARRANCAS","1","3",192,172,364
"2017",10121,"0","CERRO NAVIA         ","BARRANCAS","1","3",111,66,177
"2018",10121,"0","CERRO NAVIA         ","BARRANCAS","1","3",131,86,217
"2019",10121,"0","CERRO NAVIA         ","BARRANCAS","1","3",135,97,232
"2020",10121,"0","CERRO NAVIA         ","BARRANCAS","1","3",120,82,202
"2021",10121,"0","CERRO NAVIA         ","BARRANCAS","1","3",103,76,179
"2022",10121,"0","CERRO NAVIA         ","BARRANCAS","1","3",105,89,194
"2023",10121,"0","CERRO NAVIA         ","BARRANCAS","1","3",139,90,229
"2024",10121,"0","CERRO NAVIA         ","BARRANCAS","1","3",126,102,228
"2017",10122,"0","CERRO NAVIA         ","BARRANCAS","1","3",250,219,469
"2018",10122,"0","CERRO NAVIA         ","BARRANCAS","1","3",244,218,462
"2019",10122,"0","CERRO NAVIA         ","BARRANCAS","1","3",248,215,463
"2020",10122,"0","CERRO NAVIA         ","BARRANCAS","1","3",258,213,471
"2021",10122,"0","CERRO NAVIA         ","BARRANCAS","1","3",244,203,447
"2022",10122,"0","CERRO NAVIA         ","BARRANCAS","1","3",244,206,450
"2023",10122,"0","CERRO NAVIA         ","BARRANCAS","1","3",248,180,428
"2024",10122,"0","CERRO NAVIA         ","BARRANCAS","1","3",248,179,427
"2017",10123,"0","PUDAHUEL            ","BARRANCAS","1","3",234,223,457
"2018",10123,"0","PUDAHUEL            ","BARRANCAS","1","3",240,233,473
"2019",10123,"0","PUDAHUEL            ","BARRANCAS","1","3",237,223,460
"2020",10123,"0","PUDAHUEL            ","BARRANCAS","1","3",262,211,473
"2021",10123,"0","PUDAHUEL            ","BARRANCAS","1","3",259,212,471
"2022",10123,"0","PUDAHUEL            ","BARRANCAS","1","3",247,210,457
"2023",10123,"0","PUDAHUEL            ","BARRANCAS","1","3",251,197,448
"2024",10123,"0","PUDAHUEL            ","BARRANCAS","1","3",262,211,473
"2017",10124,"0","PUDAHUEL            ","BARRANCAS","1","3",202,173,375
"2018",10124,"0","PUDAHUEL            ","BARRANCAS","1","3",192,172,364
"2019",10124,"0","PUDAHUEL            ","BARRANCAS","1","3",206,186,392
"2020",10124,"0","PUDAHUEL            ","BARRANCAS","1","3",197,175,372
"2021",10124,"0","PUDAHUEL            ","BARRANCAS","1","3",202,177,379
"2022",10124,"0","PUDAHUEL            ","BARRANCAS","1","3",206,175,381
"2023",10124,"0","PUDAHUEL            ","BARRANCAS","1","3",175,147,322
"2024",10124,"0","PUDAHUEL            ","BARRANCAS","1","3",182,141,323
"2017",10125,"0","CERRO NAVIA         ","BARRANCAS","1","3",112,73,185
"2018",10125,"0","CERRO NAVIA         ","BARRANCAS","1","3",118,70,188
"2019",10125,"0","CERRO NAVIA         ","BARRANCAS","1","3",129,75,204
"2020",10125,"0","CERRO NAVIA         ","BARRANCAS","1","3",123,77,200
"2021",10125,"0","CERRO NAVIA         ","BARRANCAS","1","3",121,74,195
"2022",10125,"0","CERRO NAVIA         ","BARRANCAS","1","3",120,84,204
"2023",10125,"0","CERRO NAVIA         ","BARRANCAS","1","3",123,94,217
"2024",10125,"0","CERRO NAVIA         ","BARRANCAS","1","3",106,97,203
"2017",10126,"0","CERRO NAVIA         ","BARRANCAS","1","3",203,170,373
"2018",10126,"0","CERRO NAVIA         ","BARRANCAS","1","3",221,180,401
"2019",10126,"0","CERRO NAVIA         ","BARRANCAS","1","3",212,182,394
"2020",10126,"0","CERRO NAVIA         ","BARRANCAS","1","3",189,158,347
"2021",10126,"0","CERRO NAVIA         ","BARRANCAS","1","3",185,151,336
"2022",10126,"0","CERRO NAVIA         ","BARRANCAS","1","3",173,159,332
"2023",10126,"0","CERRO NAVIA         ","BARRANCAS","1","3",179,160,339
"2024",10126,"0","CERRO NAVIA         ","BARRANCAS","1","3",216,212,428
"2017",10127,"0","LO PRADO            ","BARRANCAS","1","3",116,43,159
"2018",10127,"0","LO PRADO            ","BARRANCAS","1","3",116,49,165
"2019",10127,"0","LO PRADO            ","BARRANCAS","1","3",110,44,154
"2020",10127,"0","LO PRADO            ","BARRANCAS","1","3",89,39,128
"2021",10127,"0","LO PRADO            ","BARRANCAS","1","3",94,40,134
"2022",10127,"0","LO PRADO            ","BARRANCAS","1","3",105,46,151
"2023",10127,"0","LO PRADO            ","BARRANCAS","1","3",134,53,187
"2024",10127,"0","LO PRADO            ","BARRANCAS","1","3",136,67,203
"2017",10128,"0","LO PRADO            ","BARRANCAS","1","3",250,261,511
"2018",10128,"0","LO PRADO            ","BARRANCAS","1","3",265,291,556
"2019",10128,"0","LO PRADO            ","BARRANCAS","1","3",310,314,624
"2020",10128,"0","LO PRADO            ","BARRANCAS","1","3",275,310,585
"2021",10128,"0","LO PRADO            ","BARRANCAS","1","3",291,297,588
"2022",10128,"0","LO PRADO            ","BARRANCAS","1","3",238,241,479
"2023",10128,"0","LO PRADO            ","BARRANCAS","1","3",246,252,498
"2024",10128,"0","LO PRADO            ","BARRANCAS","1","3",202,256,458
"2017",10130,"1","PUDAHUEL            ","BARRANCAS","1","3",274,260,534
"2018",10130,"1","PUDAHUEL            ","BARRANCAS","1","3",276,264,540
"2019",10130,"1","PUDAHUEL            ","BARRANCAS","1","3",272,254,526
"2020",10130,"1","PUDAHUEL            ","BARRANCAS","1","3",256,245,501
"2021",10130,"1","PUDAHUEL            ","BARRANCAS","1","3",253,254,507
"2022",10130,"1","PUDAHUEL            ","BARRANCAS","1","3",239,251,490
"2023",10130,"1","PUDAHUEL            ","BARRANCAS","1","3",244,242,486
"2024",10130,"1","PUDAHUEL            ","BARRANCAS","1","3",239,244,483
"2017",10134,"1","PUDAHUEL            ","BARRANCAS","1","3",172,196,368
"2018",10134,"1","PUDAHUEL            ","BARRANCAS","1","3",172,188,360
"2019",10134,"1","PUDAHUEL            ","BARRANCAS","1","3",171,190,361
"2020",10134,"1","PUDAHUEL            ","BARRANCAS","1","3",167,199,366
"2021",10134,"1","PUDAHUEL            ","BARRANCAS","1","3",167,202,369
"2022",10134,"1","PUDAHUEL            ","BARRANCAS","1","3",171,201,372
"2023",10134,"1","PUDAHUEL            ","BARRANCAS","1","3",165,206,371
"2024",10134,"1","PUDAHUEL            ","BARRANCAS","1","3",171,197,368
"2017",10135,"1","PUDAHUEL            ","BARRANCAS","1","3",149,100,249
"2018",10135,"1","PUDAHUEL            ","BARRANCAS","1","3",160,108,268
"2019",10135,"1","PUDAHUEL            ","BARRANCAS","1","3",154,112,266
"2020",10135,"1","PUDAHUEL            ","BARRANCAS","1","3",158,109,267
"2021",10135,"1","PUDAHUEL            ","BARRANCAS","1","3",154,107,261
"2022",10135,"1","PUDAHUEL            ","BARRANCAS","1","3",158,109,267
"2023",10135,"1","PUDAHUEL            ","BARRANCAS","1","3",163,102,265
"2024",10135,"1","PUDAHUEL            ","BARRANCAS","1","3",151,105,256
"2017",10887,"1","CAMARONES           ","CHINCHORRO","1","5",3,1,4
"2018",10887,"1","CAMARONES           ","CHINCHORRO","1","5",3,1,4
"2019",10887,"1","CAMARONES           ","CHINCHORRO","1","5",5,3,8
"2020",10887,"1","CAMARONES           ","CHINCHORRO","1","5",5,2,7
"2021",10887,"1","CAMARONES           ","CHINCHORRO","1","5",4,1,5
"2022",10887,"1","CAMARONES           ","CHINCHORRO","1","5",2,1,3
"2023",10887,"1","CAMARONES           ","CHINCHORRO","1","5",4,3,7
"2024",10887,"1","CAMARONES           ","CHINCHORRO","1","5",4,1,5
"2017",10897,"1","CAMARONES           ","CHINCHORRO","1","5",0,3,3
"2018",10897,"1","CAMARONES           ","CHINCHORRO","1","5",2,1,3
"2019",10897,"1","CAMARONES           ","CHINCHORRO","1","5",2,1,3
"2020",10897,"1","CAMARONES           ","CHINCHORRO","1","5",1,0,1
"2021",10897,"1","CAMARONES           ","CHINCHORRO","1","5",1,1,2
"2022",10897,"1","CAMARONES           ","CHINCHORRO","1","5",1,1,2
"2023",10897,"1","CAMARONES           ","CHINCHORRO","1","5",1,1,2
"2024",10897,"1","CAMARONES           ","CHINCHORRO","1","5",2,1,3
"2017",10911,"0","ARICA               ","CHINCHORRO","1","5",388,356,744
"2018",10911,"0","ARICA               ","CHINCHORRO","1","5",350,334,684
"2019",10911,"0","ARICA               ","CHINCHORRO","1","5",342,298,640
"2020",10911,"0","ARICA               ","CHINCHORRO","1","5",333,294,627
"2021",10911,"0","ARICA               ","CHINCHORRO","1","5",342,300,642
"2022",10911,"0","ARICA               ","CHINCHORRO","1","5",356,313,669
"2023",10911,"0","ARICA               ","CHINCHORRO","1","5",354,316,670
"2024",10911,"0","ARICA               ","CHINCHORRO","1","5",353,342,695
"2017",10913,"0","ARICA               ","CHINCHORRO","1","5",69,44,113
"2018",10913,"0","ARICA               ","CHINCHORRO","1","5",72,42,114
"2019",10913,"0","ARICA               ","CHINCHORRO","1","5",69,45,114
"2020",10913,"0","ARICA               ","CHINCHORRO","1","5",53,28,81
"2021",10913,"0","ARICA               ","CHINCHORRO","1","5",55,29,84
"2022",10913,"0","ARICA               ","CHINCHORRO","1","5",51,24,75
"2023",10913,"0","ARICA               ","CHINCHORRO","1","5",57,22,79
"2024",10913,"0","ARICA               ","CHINCHORRO","1","5",58,28,86
"2017",11025,"1","ALTO DEL CARMEN     ","HUASCO","1","1",58,57,115
"2018",11025,"1","ALTO DEL CARMEN     ","HUASCO","1","1",54,56,110
"2019",11025,"1","ALTO DEL CARMEN     ","HUASCO","1","1",52,57,109
"2020",11025,"1","ALTO DEL CARMEN     ","HUASCO","1","1",45,56,101
"2021",11025,"1","ALTO DEL CARMEN     ","HUASCO","1","1",48,46,94
"2022",11025,"1","ALTO DEL CARMEN     ","HUASCO","1","1",53,54,107
"2023",11025,"1","ALTO DEL CARMEN     ","HUASCO","1","1",53,50,103
"2024",11025,"1","ALTO DEL CARMEN     ","HUASCO","1","1",49,41,90
"2017",11030,"0","VALLENAR            ","HUASCO","1","1",13,2,15
"2018",11030,"0","VALLENAR            ","HUASCO","1","1",14,0,14
"2019",11030,"0","VALLENAR            ","HUASCO","1","1",11,1,12
"2020",11030,"0","VALLENAR            ","HUASCO","1","1",15,0,15
"2021",11030,"0","VALLENAR            ","HUASCO","1","1",5,0,5
"2022",11030,"0","VALLENAR            ","HUASCO","1","1",5,0,5
"2023",11030,"0","VALLENAR            ","HUASCO","1","1",23,0,23
"2024",11030,"0","VALLENAR            ","HUASCO","1","1",35,3,38
"2017",11031,"1","ALTO DEL CARMEN     ","HUASCO","1","1",6,4,10
"2018",11031,"1","ALTO DEL CARMEN     ","HUASCO","1","1",12,10,22
"2019",11031,"1","ALTO DEL CARMEN     ","HUASCO","1","1",8,11,19
"2020",11031,"1","ALTO DEL CARMEN     ","HUASCO","1","1",12,7,19
"2021",11031,"1","ALTO DEL CARMEN     ","HUASCO","1","1",11,10,21
"2022",11031,"1","ALTO DEL CARMEN     ","HUASCO","1","1",9,10,19
"2023",11031,"1","ALTO DEL CARMEN     ","HUASCO","1","1",7,10,17
"2024",11031,"1","ALTO DEL CARMEN     ","HUASCO","1","1",4,8,12
"2017",11038,"0","FREIRINA            ","HUASCO","1","1",128,152,280
"2018",11038,"0","FREIRINA            ","HUASCO","1","1",128,144,272
"2019",11038,"0","FREIRINA            ","HUASCO","1","1",156,168,324
"2020",11038,"0","FREIRINA            ","HUASCO","1","1",158,164,322
"2021",11038,"0","FREIRINA            ","HUASCO","1","1",156,170,326
"2022",11038,"0","FREIRINA            ","HUASCO","1","1",185,190,375
"2023",11038,"0","FREIRINA            ","HUASCO","1","1",193,193,386
"2024",11038,"0","FREIRINA            ","HUASCO","1","1",196,225,421
"2017",11139,"0","COQUIMBO            ","PUERTO CORDILLERA","1","2",271,244,515
"2018",11139,"0","COQUIMBO            ","PUERTO CORDILLERA","1","2",235,246,481
"2019",11139,"0","COQUIMBO            ","PUERTO CORDILLERA","1","2",227,231,458
"2020",11139,"0","COQUIMBO            ","PUERTO CORDILLERA","1","2",256,230,486
"2021",11139,"0","COQUIMBO            ","PUERTO CORDILLERA","1","2",257,223,480
"2022",11139,"0","COQUIMBO            ","PUERTO CORDILLERA","1","2",249,223,472
"2023",11139,"0","COQUIMBO            ","PUERTO CORDILLERA","1","2",284,285,569
"2024",11139,"0","COQUIMBO            ","PUERTO CORDILLERA","1","2",340,293,633
"2017",11811,"0","SAN JOAQUÍN        ","GABRIELA MISTRAL","1","6",0,391,391
"2018",11811,"0","SAN JOAQUÍN        ","GABRIELA MISTRAL","1","6",1,422,423
"2019",11811,"0","SAN JOAQUÍN        ","GABRIELA MISTRAL","1","6",0,391,391
"2020",11811,"0","SAN JOAQUÍN        ","GABRIELA MISTRAL","1","6",0,349,349
"2021",11811,"0","SAN JOAQUÍN        ","GABRIELA MISTRAL","1","6",0,308,308
"2022",11811,"0","SAN JOAQUÍN        ","GABRIELA MISTRAL","1","6",0,249,249
"2023",11811,"0","SAN JOAQUÍN        ","GABRIELA MISTRAL","1","6",0,242,242
"2024",11811,"0","SAN JOAQUÍN        ","GABRIELA MISTRAL","1","6",0,278,279
"2017",12058,"0","HUALQUI             ","ANDALIÉN SUR","1","7",270,235,505
"2018",12058,"0","HUALQUI             ","ANDALIÉN SUR","1","7",229,214,443
"2019",12058,"0","HUALQUI             ","ANDALIÉN SUR","1","7",255,247,502
"2020",12058,"0","HUALQUI             ","ANDALIÉN SUR","1","7",256,231,487
"2021",12058,"0","HUALQUI             ","ANDALIÉN SUR","1","7",272,225,497
"2022",12058,"0","HUALQUI             ","ANDALIÉN SUR","1","7",263,206,469
"2023",12058,"0","HUALQUI             ","ANDALIÉN SUR","1","7",239,183,422
"2024",12058,"0","HUALQUI             ","ANDALIÉN SUR","1","7",229,161,390
"2017",12366,"0","CARAHUE             ","COSTA ARAUCANÍA","1","4",42,31,73
"2018",12366,"0","CARAHUE             ","COSTA ARAUCANÍA","1","4",36,26,62
"2019",12366,"0","CARAHUE             ","COSTA ARAUCANÍA","1","4",38,27,65
"2020",12366,"0","CARAHUE             ","COSTA ARAUCANÍA","1","4",34,28,62
"2021",12366,"0","CARAHUE             ","COSTA ARAUCANÍA","1","4",35,30,65
"2022",12366,"0","CARAHUE             ","COSTA ARAUCANÍA","1","4",45,24,69
"2023",12366,"0","CARAHUE             ","COSTA ARAUCANÍA","1","4",45,25,70
"2024",12366,"0","CARAHUE             ","COSTA ARAUCANÍA","1","4",43,28,71
"2017",12501,"0","ARICA               ","CHINCHORRO","1","5",178,171,349
"2018",12501,"0","ARICA               ","CHINCHORRO","1","5",184,166,350
"2019",12501,"0","ARICA               ","CHINCHORRO","1","5",163,162,325
"2020",12501,"0","ARICA               ","CHINCHORRO","1","5",142,158,300
"2021",12501,"0","ARICA               ","CHINCHORRO","1","5",163,152,315
"2022",12501,"0","ARICA               ","CHINCHORRO","1","5",180,160,340
"2023",12501,"0","ARICA               ","CHINCHORRO","1","5",182,158,340
"2024",12501,"0","ARICA               ","CHINCHORRO","1","5",195,154,349
"2017",12610,"0","ARICA               ","CHINCHORRO","1","5",206,352,558
"2018",12610,"0","ARICA               ","CHINCHORRO","1","5",220,335,555
"2019",12610,"0","ARICA               ","CHINCHORRO","1","5",200,297,497
"2020",12610,"0","ARICA               ","CHINCHORRO","1","5",162,286,448
"2021",12610,"0","ARICA               ","CHINCHORRO","1","5",184,289,473
"2022",12610,"0","ARICA               ","CHINCHORRO","1","5",181,280,461
"2023",12610,"0","ARICA               ","CHINCHORRO","1","5",159,253,412
"2024",12610,"0","ARICA               ","CHINCHORRO","1","5",175,253,428
"2017",13121,"0","VALLENAR            ","HUASCO","1","1",120,120,240
"2018",13121,"0","VALLENAR            ","HUASCO","1","1",113,120,233
"2019",13121,"0","VALLENAR            ","HUASCO","1","1",124,132,256
"2020",13121,"0","VALLENAR            ","HUASCO","1","1",117,137,254
"2021",13121,"0","VALLENAR            ","HUASCO","1","1",114,128,242
"2022",13121,"0","VALLENAR            ","HUASCO","1","1",117,138,255
"2023",13121,"0","VALLENAR            ","HUASCO","1","1",124,122,246
"2024",13121,"0","VALLENAR            ","HUASCO","1","1",132,128,260
"2017",13122,"0","VALLENAR            ","HUASCO","1","1",162,78,240
"2018",13122,"0","VALLENAR            ","HUASCO","1","1",129,70,199
"2019",13122,"0","VALLENAR            ","HUASCO","1","1",138,81,219
"2020",13122,"0","VALLENAR            ","HUASCO","1","1",113,59,172
"2021",13122,"0","VALLENAR            ","HUASCO","1","1",86,76,162
"2022",13122,"0","VALLENAR            ","HUASCO","1","1",88,62,150
"2023",13122,"0","VALLENAR            ","HUASCO","1","1",99,49,148
"2024",13122,"0","VALLENAR            ","HUASCO","1","1",131,63,194
"2017",13128,"1","HUASCO              ","HUASCO","1","1",8,5,13
"2018",13128,"1","HUASCO              ","HUASCO","1","1",7,3,10
"2019",13128,"1","HUASCO              ","HUASCO","1","1",8,4,12
"2020",13128,"1","HUASCO              ","HUASCO","1","1",9,5,14
"2021",13128,"1","HUASCO              ","HUASCO","1","1",10,8,18
"2022",13128,"1","HUASCO              ","HUASCO","1","1",12,9,21
"2023",13128,"1","HUASCO              ","HUASCO","1","1",9,9,18
"2024",13128,"1","HUASCO              ","HUASCO","1","1",9,6,15
"2017",13134,"0","HUASCO              ","HUASCO","1","1",176,176,352
"2018",13134,"0","HUASCO              ","HUASCO","1","1",173,167,340
"2019",13134,"0","HUASCO              ","HUASCO","1","1",187,173,360
"2020",13134,"0","HUASCO              ","HUASCO","1","1",233,205,438
"2021",13134,"0","HUASCO              ","HUASCO","1","1",236,221,457
"2022",13134,"0","HUASCO              ","HUASCO","1","1",268,237,505
"2023",13134,"0","HUASCO              ","HUASCO","1","1",274,233,507
"2024",13134,"0","HUASCO              ","HUASCO","1","1",258,223,481
"2017",13167,"0","VALLENAR            ","HUASCO","1","1",228,240,468
"2018",13167,"0","VALLENAR            ","HUASCO","1","1",239,234,473
"2019",13167,"0","VALLENAR            ","HUASCO","1","1",243,238,481
"2020",13167,"0","VALLENAR            ","HUASCO","1","1",250,249,499
"2021",13167,"0","VALLENAR            ","HUASCO","1","1",253,258,511
"2022",13167,"0","VALLENAR            ","HUASCO","1","1",276,257,533
"2023",13167,"0","VALLENAR            ","HUASCO","1","1",284,252,536
"2024",13167,"0","VALLENAR            ","HUASCO","1","1",249,234,483
"2017",13181,"0","FREIRINA            ","HUASCO","1","1",209,189,398
"2018",13181,"0","FREIRINA            ","HUASCO","1","1",229,210,439
"2019",13181,"0","FREIRINA            ","HUASCO","1","1",234,211,445
"2020",13181,"0","FREIRINA            ","HUASCO","1","1",231,210,441
"2021",13181,"0","FREIRINA            ","HUASCO","1","1",255,214,469
"2022",13181,"0","FREIRINA            ","HUASCO","1","1",266,239,505
"2023",13181,"0","FREIRINA            ","HUASCO","1","1",244,220,464
"2024",13181,"0","FREIRINA            ","HUASCO","1","1",238,218,456
"2017",13185,"0","VALLENAR            ","HUASCO","1","1",227,482,709
"2018",13185,"0","VALLENAR            ","HUASCO","1","1",272,453,725
"2019",13185,"0","VALLENAR            ","HUASCO","1","1",257,461,718
"2020",13185,"0","VALLENAR            ","HUASCO","1","1",235,429,664
"2021",13185,"0","VALLENAR            ","HUASCO","1","1",242,452,694
"2022",13185,"0","VALLENAR            ","HUASCO","1","1",221,432,653
"2023",13185,"0","VALLENAR            ","HUASCO","1","1",252,458,710
"2024",13185,"0","VALLENAR            ","HUASCO","1","1",302,510,812
"2017",13202,"0","VALLENAR            ","HUASCO","1","1",221,271,492
"2018",13202,"0","VALLENAR            ","HUASCO","1","1",225,284,509
"2019",13202,"0","VALLENAR            ","HUASCO","1","1",222,278,500
"2020",13202,"0","VALLENAR            ","HUASCO","1","1",231,257,488
"2021",13202,"0","VALLENAR            ","HUASCO","1","1",243,250,493
"2022",13202,"0","VALLENAR            ","HUASCO","1","1",241,257,498
"2023",13202,"0","VALLENAR            ","HUASCO","1","1",244,260,504
"2024",13202,"0","VALLENAR            ","HUASCO","1","1",245,252,497
"2017",13461,"0","COQUIMBO            ","PUERTO CORDILLERA","1","2",109,118,227
"2018",13461,"0","COQUIMBO            ","PUERTO CORDILLERA","1","2",106,113,219
"2019",13461,"0","COQUIMBO            ","PUERTO CORDILLERA","1","2",130,114,244
"2020",13461,"0","COQUIMBO            ","PUERTO CORDILLERA","1","2",127,102,229
"2021",13461,"0","COQUIMBO            ","PUERTO CORDILLERA","1","2",140,124,264
"2022",13461,"0","COQUIMBO            ","PUERTO CORDILLERA","1","2",158,119,277
"2023",13461,"0","COQUIMBO            ","PUERTO CORDILLERA","1","2",160,160,320
"2024",13461,"0","COQUIMBO            ","PUERTO CORDILLERA","1","2",174,192,366
"2017",13557,"0","COQUIMBO            ","PUERTO CORDILLERA","1","2",112,103,215
"2018",13557,"0","COQUIMBO            ","PUERTO CORDILLERA","1","2",121,132,253
"2019",13557,"0","COQUIMBO            ","PUERTO CORDILLERA","1","2",141,121,262
"2020",13557,"0","COQUIMBO            ","PUERTO CORDILLERA","1","2",147,128,275
"2021",13557,"0","COQUIMBO            ","PUERTO CORDILLERA","1","2",140,141,281
"2022",13557,"0","COQUIMBO            ","PUERTO CORDILLERA","1","2",156,154,310
"2023",13557,"0","COQUIMBO            ","PUERTO CORDILLERA","1","2",153,146,299
"2024",13557,"0","COQUIMBO            ","PUERTO CORDILLERA","1","2",144,157,301
"2017",13558,"0","COQUIMBO            ","PUERTO CORDILLERA","1","2",224,286,510
"2018",13558,"0","COQUIMBO            ","PUERTO CORDILLERA","1","2",279,328,607
"2019",13558,"0","COQUIMBO            ","PUERTO CORDILLERA","1","2",298,308,606
"2020",13558,"0","COQUIMBO            ","PUERTO CORDILLERA","1","2",305,311,616
"2021",13558,"0","COQUIMBO            ","PUERTO CORDILLERA","1","2",304,321,625
"2022",13558,"0","COQUIMBO            ","PUERTO CORDILLERA","1","2",286,278,564
"2023",13558,"0","COQUIMBO            ","PUERTO CORDILLERA","1","2",291,304,595
"2024",13558,"0","COQUIMBO            ","PUERTO CORDILLERA","1","2",294,293,587
"2017",13559,"0","COQUIMBO            ","PUERTO CORDILLERA","1","2",163,152,315
"2018",13559,"0","COQUIMBO            ","PUERTO CORDILLERA","1","2",176,170,346
"2019",13559,"0","COQUIMBO            ","PUERTO CORDILLERA","1","2",213,179,392
"2020",13559,"0","COQUIMBO            ","PUERTO CORDILLERA","1","2",227,211,438
"2021",13559,"0","COQUIMBO            ","PUERTO CORDILLERA","1","2",243,218,461
"2022",13559,"0","COQUIMBO            ","PUERTO CORDILLERA","1","2",230,205,435
"2023",13559,"0","COQUIMBO            ","PUERTO CORDILLERA","1","2",214,188,402
"2024",13559,"0","COQUIMBO            ","PUERTO CORDILLERA","1","2",208,185,393
"2017",13560,"0","COQUIMBO            ","PUERTO CORDILLERA","1","2",125,120,245
"2018",13560,"0","COQUIMBO            ","PUERTO CORDILLERA","1","2",126,117,243
"2019",13560,"0","COQUIMBO            ","PUERTO CORDILLERA","1","2",112,115,227
"2020",13560,"0","COQUIMBO            ","PUERTO CORDILLERA","1","2",120,110,230
"2021",13560,"0","COQUIMBO            ","PUERTO CORDILLERA","1","2",117,120,237
"2022",13560,"0","COQUIMBO            ","PUERTO CORDILLERA","1","2",129,125,254
"2023",13560,"0","COQUIMBO            ","PUERTO CORDILLERA","1","2",131,123,254
"2024",13560,"0","COQUIMBO            ","PUERTO CORDILLERA","1","2",111,102,213
"2017",13561,"0","COQUIMBO            ","PUERTO CORDILLERA","1","2",223,305,528
"2018",13561,"0","COQUIMBO            ","PUERTO CORDILLERA","1","2",206,314,520
"2019",13561,"0","COQUIMBO            ","PUERTO CORDILLERA","1","2",240,296,536
"2020",13561,"0","COQUIMBO            ","PUERTO CORDILLERA","1","2",249,287,536
"2021",13561,"0","COQUIMBO            ","PUERTO CORDILLERA","1","2",250,270,520
"2022",13561,"0","COQUIMBO            ","PUERTO CORDILLERA","1","2",265,270,535
"2023",13561,"0","COQUIMBO            ","PUERTO CORDILLERA","1","2",254,282,536
"2024",13561,"0","COQUIMBO            ","PUERTO CORDILLERA","1","2",243,290,533
"2017",13562,"0","COQUIMBO            ","PUERTO CORDILLERA","1","2",147,144,291
"2018",13562,"0","COQUIMBO            ","PUERTO CORDILLERA","1","2",134,125,259
"2019",13562,"0","COQUIMBO            ","PUERTO CORDILLERA","1","2",133,121,254
"2020",13562,"0","COQUIMBO            ","PUERTO CORDILLERA","1","2",144,134,278
"2021",13562,"0","COQUIMBO            ","PUERTO CORDILLERA","1","2",151,126,277
"2022",13562,"0","COQUIMBO            ","PUERTO CORDILLERA","1","2",142,116,258
"2023",13562,"0","COQUIMBO            ","PUERTO CORDILLERA","1","2",116,105,221
"2024",13562,"0","COQUIMBO            ","PUERTO CORDILLERA","1","2",104,102,206
"2017",13563,"0","ANDACOLLO           ","PUERTO CORDILLERA","1","2",100,88,188
"2018",13563,"0","ANDACOLLO           ","PUERTO CORDILLERA","1","2",103,92,195
"2019",13563,"0","ANDACOLLO           ","PUERTO CORDILLERA","1","2",101,92,193
"2020",13563,"0","ANDACOLLO           ","PUERTO CORDILLERA","1","2",95,95,190
"2021",13563,"0","ANDACOLLO           ","PUERTO CORDILLERA","1","2",90,90,180
"2022",13563,"0","ANDACOLLO           ","PUERTO CORDILLERA","1","2",98,83,181
"2023",13563,"0","ANDACOLLO           ","PUERTO CORDILLERA","1","2",101,79,180
"2024",13563,"0","ANDACOLLO           ","PUERTO CORDILLERA","1","2",103,76,179
"2017",13611,"0","ANDACOLLO           ","PUERTO CORDILLERA","1","2",38,38,76
"2018",13611,"0","ANDACOLLO           ","PUERTO CORDILLERA","1","2",36,40,76
"2019",13611,"0","ANDACOLLO           ","PUERTO CORDILLERA","1","2",43,39,82
"2020",13611,"0","ANDACOLLO           ","PUERTO CORDILLERA","1","2",46,45,91
"2021",13611,"0","ANDACOLLO           ","PUERTO CORDILLERA","1","2",50,48,98
"2022",13611,"0","ANDACOLLO           ","PUERTO CORDILLERA","1","2",41,24,65
"2023",13611,"0","ANDACOLLO           ","PUERTO CORDILLERA","1","2",37,29,66
"2024",13611,"0","ANDACOLLO           ","PUERTO CORDILLERA","1","2",34,22,56
"2017",17709,"0","CHIGUAYANTE         ","ANDALIÉN SUR","1","7",87,72,159
"2018",17709,"0","CHIGUAYANTE         ","ANDALIÉN SUR","1","7",83,53,136
"2019",17709,"0","CHIGUAYANTE         ","ANDALIÉN SUR","1","7",64,51,115
"2020",17709,"0","CHIGUAYANTE         ","ANDALIÉN SUR","1","7",49,47,96
"2021",17709,"0","CHIGUAYANTE         ","ANDALIÉN SUR","1","7",48,46,94
"2022",17709,"0","CHIGUAYANTE         ","ANDALIÉN SUR","1","7",48,34,82
"2023",17709,"0","CHIGUAYANTE         ","ANDALIÉN SUR","1","7",47,50,97
"2024",17709,"0","CHIGUAYANTE         ","ANDALIÉN SUR","1","7",56,36,92
"2017",18065,"0","HUALQUI             ","ANDALIÉN SUR","1","7",200,171,371
"2018",18065,"0","HUALQUI             ","ANDALIÉN SUR","1","7",195,161,356
"2019",18065,"0","HUALQUI             ","ANDALIÉN SUR","1","7",180,151,331
"2020",18065,"0","HUALQUI             ","ANDALIÉN SUR","1","7",179,145,324
"2021",18065,"0","HUALQUI             ","ANDALIÉN SUR","1","7",166,138,304
"2022",18065,"0","HUALQUI             ","ANDALIÉN SUR","1","7",172,127,299
"2023",18065,"0","HUALQUI             ","ANDALIÉN SUR","1","7",170,139,309
"2024",18065,"0","HUALQUI             ","ANDALIÉN SUR","1","7",152,126,278
"2017",18112,"0","FLORIDA             ","ANDALIÉN SUR","1","7",234,200,434
"2018",18112,"0","FLORIDA             ","ANDALIÉN SUR","1","7",239,211,450
"2019",18112,"0","FLORIDA             ","ANDALIÉN SUR","1","7",241,224,465
"2020",18112,"0","FLORIDA             ","ANDALIÉN SUR","1","7",252,235,487
"2021",18112,"0","FLORIDA             ","ANDALIÉN SUR","1","7",244,241,485
"2022",18112,"0","FLORIDA             ","ANDALIÉN SUR","1","7",239,244,483
"2023",18112,"0","FLORIDA             ","ANDALIÉN SUR","1","7",224,237,461
"2024",18112,"0","FLORIDA             ","ANDALIÉN SUR","1","7",246,226,472
"2017",20053,"1","TEODORO SCHMIDT     ","COSTA ARAUCANÍA","1","4",41,28,69
"2018",20053,"1","TEODORO SCHMIDT     ","COSTA ARAUCANÍA","1","4",42,34,76
"2019",20053,"1","TEODORO SCHMIDT     ","COSTA ARAUCANÍA","1","4",39,31,70
"2020",20053,"1","TEODORO SCHMIDT     ","COSTA ARAUCANÍA","1","4",29,25,54
"2021",20053,"1","TEODORO SCHMIDT     ","COSTA ARAUCANÍA","1","4",36,30,66
"2022",20053,"1","TEODORO SCHMIDT     ","COSTA ARAUCANÍA","1","4",51,46,97
"2023",20053,"1","TEODORO SCHMIDT     ","COSTA ARAUCANÍA","1","4",66,55,121
"2024",20053,"1","TEODORO SCHMIDT     ","COSTA ARAUCANÍA","1","4",73,53,126
"2017",20248,"0","CARAHUE             ","COSTA ARAUCANÍA","1","4",86,82,168
"2018",20248,"0","CARAHUE             ","COSTA ARAUCANÍA","1","4",84,90,174
"2019",20248,"0","CARAHUE             ","COSTA ARAUCANÍA","1","4",79,81,160
"2020",20248,"0","CARAHUE             ","COSTA ARAUCANÍA","1","4",70,76,146
"2021",20248,"0","CARAHUE             ","COSTA ARAUCANÍA","1","4",87,81,168
"2022",20248,"0","CARAHUE             ","COSTA ARAUCANÍA","1","4",105,73,178
"2023",20248,"0","CARAHUE             ","COSTA ARAUCANÍA","1","4",101,93,194
"2024",20248,"0","CARAHUE             ","COSTA ARAUCANÍA","1","4",98,103,201
"2017",24412,"0","PUDAHUEL            ","BARRANCAS","1","3",250,203,453
"2018",24412,"0","PUDAHUEL            ","BARRANCAS","1","3",267,204,471
"2019",24412,"0","PUDAHUEL            ","BARRANCAS","1","3",256,205,461
"2020",24412,"0","PUDAHUEL            ","BARRANCAS","1","3",239,198,437
"2021",24412,"0","PUDAHUEL            ","BARRANCAS","1","3",236,177,413
"2022",24412,"0","PUDAHUEL            ","BARRANCAS","1","3",219,181,400
"2023",24412,"0","PUDAHUEL            ","BARRANCAS","1","3",220,184,404
"2024",24412,"0","PUDAHUEL            ","BARRANCAS","1","3",193,156,349
"2017",24754,"0","CERRO NAVIA         ","BARRANCAS","1","3",222,199,421
"2018",24754,"0","CERRO NAVIA         ","BARRANCAS","1","3",195,231,426
"2019",24754,"0","CERRO NAVIA         ","BARRANCAS","1","3",227,254,481
"2020",24754,"0","CERRO NAVIA         ","BARRANCAS","1","3",206,238,444
"2021",24754,"0","CERRO NAVIA         ","BARRANCAS","1","3",203,199,402
"2022",24754,"0","CERRO NAVIA         ","BARRANCAS","1","3",202,161,363
"2023",24754,"0","CERRO NAVIA         ","BARRANCAS","1","3",243,178,421
"2024",24754,"0","CERRO NAVIA         ","BARRANCAS","1","3",166,157,323
"2017",24804,"0","CERRO NAVIA         ","BARRANCAS","1","3",82,66,148
"2018",24804,"0","CERRO NAVIA         ","BARRANCAS","1","3",91,69,160
"2019",24804,"0","CERRO NAVIA         ","BARRANCAS","1","3",107,62,169
"2020",24804,"0","CERRO NAVIA         ","BARRANCAS","1","3",100,66,166
"2021",24804,"0","CERRO NAVIA         ","BARRANCAS","1","3",100,61,161
"2022",24804,"0","CERRO NAVIA         ","BARRANCAS","1","3",101,50,151
"2023",24804,"0","CERRO NAVIA         ","BARRANCAS","1","3",96,49,145
"2024",24804,"0","CERRO NAVIA         ","BARRANCAS","1","3",97,42,139
"2017",24889,"0","PUDAHUEL            ","BARRANCAS","1","3",570,521,1091
"2018",24889,"0","PUDAHUEL            ","BARRANCAS","1","3",555,497,1052
"2019",24889,"0","PUDAHUEL            ","BARRANCAS","1","3",584,488,1072
"2020",24889,"0","PUDAHUEL            ","BARRANCAS","1","3",575,500,1075
"2021",24889,"0","PUDAHUEL            ","BARRANCAS","1","3",533,496,1029
"2022",24889,"0","PUDAHUEL            ","BARRANCAS","1","3",513,474,987
"2023",24889,"0","PUDAHUEL            ","BARRANCAS","1","3",477,505,982
"2024",24889,"0","PUDAHUEL            ","BARRANCAS","1","3",545,488,1033
"2017",25047,"0","PUDAHUEL            ","BARRANCAS","1","3",667,530,1197
"2018",25047,"0","PUDAHUEL            ","BARRANCAS","1","3",707,550,1257
"2019",25047,"0","PUDAHUEL            ","BARRANCAS","1","3",715,565,1280
"2020",25047,"0","PUDAHUEL            ","BARRANCAS","1","3",678,537,1215
"2021",25047,"0","PUDAHUEL            ","BARRANCAS","1","3",638,505,1143
"2022",25047,"0","PUDAHUEL            ","BARRANCAS","1","3",624,525,1149
"2023",25047,"0","PUDAHUEL            ","BARRANCAS","1","3",550,457,1007
"2024",25047,"0","PUDAHUEL            ","BARRANCAS","1","3",500,403,903
"2017",25315,"0","PUDAHUEL            ","BARRANCAS","1","3",230,175,405
"2018",25315,"0","PUDAHUEL            ","BARRANCAS","1","3",196,169,365
"2019",25315,"0","PUDAHUEL            ","BARRANCAS","1","3",207,174,381
"2020",25315,"0","PUDAHUEL            ","BARRANCAS","1","3",207,170,377
"2021",25315,"0","PUDAHUEL            ","BARRANCAS","1","3",198,151,349
"2022",25315,"0","PUDAHUEL            ","BARRANCAS","1","3",187,152,339
"2023",25315,"0","PUDAHUEL            ","BARRANCAS","1","3",165,111,276
"2024",25315,"0","PUDAHUEL            ","BARRANCAS","1","3",166,117,283
"2017",25514,"0","MACUL               ","GABRIELA MISTRAL","1","6",197,152,349
"2018",25514,"0","MACUL               ","GABRIELA MISTRAL","1","6",178,153,331
"2019",25514,"0","MACUL               ","GABRIELA MISTRAL","1","6",217,152,369
"2020",25514,"0","MACUL               ","GABRIELA MISTRAL","1","6",213,138,351
"2021",25514,"0","MACUL               ","GABRIELA MISTRAL","1","6",195,145,340
"2022",25514,"0","MACUL               ","GABRIELA MISTRAL","1","6",175,126,301
"2023",25514,"0","MACUL               ","GABRIELA MISTRAL","1","6",189,124,313
"2024",25514,"0","MACUL               ","GABRIELA MISTRAL","1","6",187,135,322
"2017",26501,"0","LA GRANJA           ","GABRIELA MISTRAL","1","6",200,205,405
"2018",26501,"0","LA GRANJA           ","GABRIELA MISTRAL","1","6",199,204,403
"2019",26501,"0","LA GRANJA           ","GABRIELA MISTRAL","1","6",201,180,381
"2020",26501,"0","LA GRANJA           ","GABRIELA MISTRAL","1","6",205,151,356
"2021",26501,"0","LA GRANJA           ","GABRIELA MISTRAL","1","6",220,160,380
"2022",26501,"0","LA GRANJA           ","GABRIELA MISTRAL","1","6",233,185,418
"2023",26501,"0","LA GRANJA           ","GABRIELA MISTRAL","1","6",232,163,395
"2024",26501,"0","LA GRANJA           ","GABRIELA MISTRAL","1","6",225,163,388
"2017",40340,"1","ALTO DEL CARMEN     ","HUASCO","1","1",119,109,228
"2018",40340,"1","ALTO DEL CARMEN     ","HUASCO","1","1",108,112,220
"2019",40340,"1","ALTO DEL CARMEN     ","HUASCO","1","1",115,115,230
"2020",40340,"1","ALTO DEL CARMEN     ","HUASCO","1","1",125,113,238
"2021",40340,"1","ALTO DEL CARMEN     ","HUASCO","1","1",127,116,243
"2022",40340,"1","ALTO DEL CARMEN     ","HUASCO","1","1",121,106,227
"2023",40340,"1","ALTO DEL CARMEN     ","HUASCO","1","1",116,122,238
"2024",40340,"1","ALTO DEL CARMEN     ","HUASCO","1","1",119,127,246
